Subpop report generated 10-07-25 12:51:07

fastq:	/mnt/scratch45/sbiam21/all_crypto/bloomine/BlooMine_RUNDIR/SRR10363363_47028/Cp_gp60_IIa/SRR10363363_47028.Cp_gp60_IIa_BMfiltered.fq
flanks_fasta flanks:	/mnt/scratch45/sbiam21/all_crypto/bloomine/BlooMine_RUNDIR/tmp.Cp_gp60_IIa_flanks.fa


Sequence variants:
TGATGTTGATGTTGATGATGATGATGATGATGATGATGATGATGATGACGATGACGATGATGA	246
TGATGTTGATGTTGATGATGATGATGATGATGATGATGATGACGATGACGATGATGA	2
TGATGTTGATGTTGATGATGGTGATGATGATGATGAGGATGATGATGACGATGACGAGGATGA	1
TGATGTTGATGTTGATGATGATGATGATGATGATGATGATGATGACGATGACGATGATGA	16
TGATGTTGATGTTGATGATGATGATGATGATGATGATGATGATGATGGCGATGACGATGATGA	2
TGATGTTGATGTTGTTGATGATGATGATGATGATGATGATGATGATGACGATGACGATGATGA	1
TGATGTTGATGTTGATGATGATGATGATGATGATGATGATGATGATGACGAGGACGATGATGA	1
TGATGTTGATGTTGATGATGATGATGATGATGATGATGATGATGATGACTATGACGATGATGA	1
TGATGTTGGTGTTGATGATGATGATGATGATGATGATGATGAAGATGACGATGACGATGATGA	1
TGATGTTGATGTTGATGATGATGATGATGATGATGATGATGATGATGACGATGGCGATGATGA	1
TTATTTTGATGTTTCTTATGATGATGATGATGATGATGATGATGATGACGATGACGATGATGA	1
TGATGTTGATGTTGCTGATGCTGATGATGATGATGATGATGATGATGACGATGACGATGATGA	1
TGATGTTGATGTTGATGATGATGATGATGATGATGATGATGGTGATGACGATGACGATGATGA	2
TGATGTTGATGTTGATGATGATGATGATGATGATGATGATGATGATGATGATGACGATGACGATGATGA	2
TGATGTTGATGTTGATGATGATGATGATGATGATGATGATGATGATGATGACGATGACGATGATGA	3
TGATGTTGATGTTGATGATGATGATGAAGATGATGATGATGATGATGGCGATGACGATGATGA	1
AGATGTTGATGTTGATGATGATGATGATGATGATGATGATGATGATGACGATGACGATGATGA	1
TGATGTTGATGTTGATGATGATGATGATGATGATGATGATGATGATGACGATGACAATGATGA	1
TGATGTTGATGTTGATGATGATGATGATGATGATGAAGATGATGATGACGATGACGATGATGA	1
TGATGTTGATGATGATGATGATGATGATGATGATGATGATGATGACGATGACGATGATGA	2
TGATGTTGATGTTGATGATGCTGATGATGATGATGATGATGATGATGACGATGACGATGATGA	2
TGATGTTGATGTTGATGATGATGATGATGATGATGATGATGATGA	1
TGATGTTGATGTTGATGATGTTGATGTTGATGATGATGATGATGATGACGATGACGATGATGA	2
TTGATGTTGATGTTGATGATGATGATGATGATGATGATGATGATGATGACGATGACGATGATGA	1
TGATGTTGATGTTGATGATGATGATGATGGTGATGATGATGATGCTGACGATGACGATGGTGA	1
TGATGATGATGTTGATGATGATGATGATGATGATGATGATGATGATGACGATGACGATGATGA	1
TGATGTTGATGTTGATGATGAGGATGATGATGATGATGATGATGATGACGATGACGATGATGA	1
TGATGTTGCTGTTGATGATGATGATGATGATGATGATGATGATGATGACGATGACGATGAGGA	1
TGATGTTGATGTTGATGATGATGATGCTGATGATGATGATGATGATGACGCTGACGATGATGA	1
TGATGGTGATGTTGANGATGATGATGATGATGATGATGATGATGATGACGATGACGATGATGA	1
TGATGTTGATGTTGATGATGATGATGATGATGATGATGATGATGATGACGATGACGATGANGA	1
TGAAGTTGATGTTGATGATGATGATGATGATGAAGAGGAAGATGATGANGATGACGATGATGA	1
TGATGGTGATGTTGATGATGATGATGACGATGATGATGATGATGATGACGATGACGATGATGA	1
TGATGTTGATGTTGATGATGATGATGATGATGATGAGGATGATGATGACGATGATGATGATGA	1
TGATGTTGATGNTGATGATGATGATGATGATGATGATGATGATGAAGTCGATGACGATAATGA	1
TGATGTTGATGTTGATGATGANGATGATGATGATGATGATGATGATGACGATGACGATGATGA	1
TGATGTTGATGNTGATGATGATGATGATGATGATGATGATGATGATGACGATGACGATGATGA	2
TGCTGTTGATGTTGATGATGATGATGATGATGATGATGATGATGATGACGATGACGATGATGA	1
TGATGTTGATGTTGATGATGATNATGATGATGATGATGATGATGATGACGATGACGATGATGA	1
TGATGTTGATGTTGATGATGATGATGATGATGATGATGATGATGATGACGATNACGATGATGA	1
TGATGTTGATGTTGATGATGATGATGATGATGATGNTGATGATGATGACGATGACGCTGATGA	1
TGATGTTGATGTTGCTGATGATGATGATGATGATGATGATGATGATGACGATGACGATGATGA	1
TGATGTTGATGTTGATGATGATGATAATGATGATGATGATGATGA	1
TGATGTTGATGTTGATGATGATGATGNTGATGATGATGATGATGATGACGATGACGATGATGA	1
TGATGTTGATGTTGATGATGATGATGATNATGATGATGATGATGATGACGATGACGATGATGA	1

Length variants:
63	287
57	2
60	18
69	2
66	3
45	2
64	1

