Subpop report generated 12-07-25 05:30:22

fastq:	/mnt/scratch45/sbiam21/all_crypto/bloomine/BlooMine_RUNDIR/SRR10363537_44290/Cp_gp60_IId/SRR10363537_44290.Cp_gp60_IId_BMfiltered.fq
flanks_fasta flanks:	/mnt/scratch45/sbiam21/all_crypto/bloomine/BlooMine_RUNDIR/tmp.Cp_gp60_IId_flanks.fa


Sequence variants:
TCGATGTTGATGATGATGATGATGACGATGATGATGATGATGATGATGATGATGATGATGATGATGA	263
TCGATGTTGATGATGATGATGATGACGATGATGATGATGATGATGATGATGATGATGATGATGA	19
TCGATGTTGATGATGATGATGAGGACGATGATGATGATGATGAAGATGATGATGATGATGATGATGA	1
TCGATGGTGATGATGATGATGATGACGATGATGATGATGATGATGATGATGATGATGATGATGATGA	1
TCGATGTTGATGATGATGATGATGACGATGACGATGATGATGATGATGATGATGATGATGATGATGA	3
GCGATGTTGATGATGATGATGATGACGATGATGATGATGATGATGATGATGATGATGATGATGATGA	1
TCGATGTTGATGATGATGATGATGACGATGATGATGATGATGATGATGATGATGATGATGATGATGATGA	1
TCGATGTTGATGATGATGACGATGATGATGATGATGATGATGATGATGATGATGATGA	1
TCGATGTTGATGATGATGATGATGACGATGATGATGATGATGATGATGATGATGA	2
TCGATGTTGATGATGATGATGATGACGATGATGATGATGATGATGATGATGATGATGACGATGATGA	1
TCGATGTTGATGATGATGATGATGACTATGATGATGATGATGTTGATGATGATGATGATGA	1
TCGATGTTGATGATGATGATGACGATGATGATGATGATGATGATGATGATGATGATGATGATGA	2
TCGATGTTGATGATGATGATGATGACGATGATGACGATGATGATGATGATGATGATGATGATGATGA	1
TCGATGTTGATGATGATGATGATGACGATGATGATGATGATGATGATGATGATGATGATGA	4
TCGATGTTGATGATGATGATGATGACGATGATGATGCTGATGATGATGATGATGATGATGATGATGA	1
TCGATGTTGATGATGATGATGATGAAGATGATGATGATGATGATGATGATGATGATGATGATGATGA	1
TCGATGTTGATGATGATGATGATGACGATGATGATGATGATGATGATGATGACGATGATGATGATCA	1
TAGATGTTGATGATGATGATGATGACGATGATGATGATGATGATGATGATGATGATAATGATGATGA	1
TCGCTGTTGATGATGATGATGATGACGATGATGATGATGATGATGATGATGATGATGATGATGATGA	1
GCGATGTTGATGATGATGATGATGACGATGATTATGATGATGGTGATGGTGATGAGGTTGATGATGA	1
TCGATGTTGATGATGATGATGATGACGATGATGATGATGATGATGATGATGATGATGCTGATGATGA	1
TGGATGTTGATGATGATGATGATGACGATGATGATGATGATGATGATGATGATGATGATGATGATGA	1
TCGATGTTGATGATGATGATGATGACTTTGATGATGATGATGATGATGATGATGATGTTGATGATGA	1
TCGTTGTTGATGATGATGATGATGACGTTGATGATGATGTTGATGTTGATGATGATGATGATGATGA	1
TCGATGTTGATGATGATGATGA	1
TCGATTTTGATTATGATGATGATGACGATTATTATGATGATTATGATTATTATGATTATGATGATTA	1
TCGATGTTGATGATGATGATGATGACGATTATGATGATGATGATGATGATGATGATGATGATGA	1
TCGATGTTGATGATGATGATGATGACGATGATGATGATGATGATGATGATGATGATGATGATGACGA	1
TCGATGTTGATGATGATGATGATGACGACGATGATGATGATGATGATGATGATGATGATGATGATGA	1
TCGATGTTGATGATGATGATGATGACGATGATGATGATGATGATGATGATGATGAAGATGATGATGA	1
TCGATGTTGATGATGATGATGATGACGATGATGATGATGAGGATGATGATGATGATGATGATGATGA	1
TCGATGTTGATGATGATGATGATGACGATGATGATGATGATGATGATGATGATGATGAAGATGA	1

Length variants:
67	286
64	23
70	1
58	1
55	2
61	5
22	1

