Subpop report generated 11-07-25 13:24:15

fastq:	/mnt/scratch45/sbiam21/all_crypto/bloomine/BlooMine_RUNDIR/SRR10363509_43328/Cp_gp60_IIa/SRR10363509_43328.Cp_gp60_IIa_BMfiltered.fq
flanks_fasta flanks:	/mnt/scratch45/sbiam21/all_crypto/bloomine/BlooMine_RUNDIR/tmp.Cp_gp60_IIa_flanks.fa


Sequence variants:
TGATGTTGATGATGATGATGATGATGATGATGATGATGATGACGATGACGATGATGA	50
TGATGTTGATGTTGATGATGATGATGATGATGATGATGATGATGATGATGATGACGATGACGATGATGA	103
TGATGTTGATGATGATGATGATGATGATGATGATGATGATGATGATGATGACGATGACGATGATGA	1
TGATGTTGATGTTGATGATGATGTTTATGATGATGATGATGATGATGATGATGACGATGACGATGATGA	1
TGATGTTGATGTTGATGACGATGATGATGATGATGATGATGATGATGATGATGACTATGACGATGACGA	1
TGATGTTGATGACGATGATGATGATGATGATGATCATGATGACGATGACGATGATGA	1
TGATGTTGATGTTGATGATGATGATGATGATGATGATGATGATGATGATGACGATGACGATGATGA	5
TGATGTTGATGTTGATGATGATGATGATGATGATGATGATGATGATGATGATGACGATGACGATGATGC	1
TGATGTTGATGTTGATGATGATGATGATGATGATGATGATGACGATGATGACGATGACGATGATGA	1
TGATGTTGATGATGATGATGATGATGATGATGATGATGACGATGACGATGATGA	3
TGATGTTGATGATGATGATGATGATGATGATGATGATGATGACGATGCCGATGATGA	1
TGATGTTGATGTTGATGATGATGATGNTGATNNNGATGATGNNNNTGANGGCGATGANGATGATGA	1
TTATGTTGATGAGGATGATGATGATGATGATGATGATGATGACGATGACGATTATGG	1
TGATGTTGATGTTGATGATGATGATGATGATGATGATGATGATGATGACGATGACGATGATGA	2
TGATGTTGATGTTGATGATGATGATGATGATGATGATGATGATGATGATGATGATGACGATGACGATGATGA	2
TGATGTTGATGTTGATGATGATGATGATGATGATGATGATGATGATGATGATGACTATGACGATGATGA	1
TGATGTTGATGACGATGATGATGAGGATGATGATGATGATGACGATGACGATGATGA	1
TGATGTTGATGTTGATGATGATGATGATGATGATGATGATGATTATGATGATGACGATGACGATGATGA	1
TGATGTTGCAGTTGATGATGATGATGATTATGATGATGATGATGATGATGATGACGATGACGATGATGA	1
TTTTGTTGATGTTGATGATGATGATGATGATGATTATGATGATGATTATTATGACGATGATGATGATTA	1
TGATGTTGATGTTGATGGTGATGATGATGATGATGATGATGATGATGCTGATGACGATGACGATGATGA	1
TGCTGTTGATGATGATGATGATGATGATGATGATGATGATGACGATGACGATGATGA	1
TGATGTTGATGATGATGATGATGATTATGATGATGATGATGACGATGACGATGATGA	1
TGATGTTGATGATGATGATGATGATGATGATGATGATGATGACGATGACGATGAAGA	1
TGATGTTGATGTTGATGTTGACGATGATGATGATGATGATGATGATGATGATGACGATGAGGATGATGA	1
TGTTGTTGATGTTGATGATGATGATGATGATGATGATGATGATGATGATGATGACGATGACGATGATGA	1
TGATGTTGATGTTGATGATGATGATGATGGGGATGCTGAGGAGGATGACGATGACGATGATGA	1
TGATGGTGATGTTGGTGATGATGATGATGATGATGATGATGATGATGATGATGTGGATGTCGATGATGA	1
TGATGTTGATGTTGATGTTGATGTTGATGTTGATGATGATGTTGATGATGATGACGATGACGATGATGA	1
TGATGTTGATGTTGATGATGATGATGATGATGATGATGATGCTGATGATGATGACGATGACGATGATGA	1
TGATGTTGATGTTGATGATGATGATGATGATGATGATGATGATGATGATGACGATGATGATGATGA	1
TGATGTTGATGTTGATGATGCTGATGATGATGATGATGATGATGATGATGATGACGATGACGATGATGA	1

Length variants:
57	57
69	117
66	9
54	3
63	3
72	2

