Subpop report generated 10-07-25 08:59:14

fastq:	/mnt/scratch45/sbiam21/all_crypto/bloomine/BlooMine_RUNDIR/SRR10363343_43443/Cp_gp60_IIa/SRR10363343_43443.Cp_gp60_IIa_BMfiltered.fq
flanks_fasta flanks:	/mnt/scratch45/sbiam21/all_crypto/bloomine/BlooMine_RUNDIR/tmp.Cp_gp60_IIa_flanks.fa


Sequence variants:
TGATGTTGATGTTGATGATGATGATGATGATGATGATGATGATGATGACGATGACGATGATGA	244
TGATGTTGATGTTGATGATGATGATGATGATGATGATGACGATGACGATGATGA	1
TGATGTTGATGTTGATGATGATGATGATGATGATGATGATGATGATGACGATGATGA	1
TGATGTTGATGTTGATGATGATGATGATGATGATGATGATGACGATGACGATGATGA	3
TGATGTTGATGTTGATGATGATGATGATGATGATGATGACGATGATGACGATGACGATGATGA	1
TGATGTTGATGTCGATGATGATGATGATGATGATGATGATGATGATGACGATGACGATGATGA	1
TGGTGTTGATGTTGATGTTGACGATGATGATGATGATGATGATGTTGACGATGACGATGTTGA	1
TGATGTTGATGTTGATGATGATGATGATGATGATGATGATGATGACGATGACGATGATGA	7
TGATGATGATGTTGATGATGATGATGATGATGATGATGATGATGATGACGATGACGATGATGA	1
TGATGTTGATGATGATGATGATGATGATGATGATGATGATGATGACGATGACGATGATGA	1
TGATGTTGATGTGGATGATGATGATGATGATGATGATGATGATGATGACGATGACGATGATGA	1
TGATGTTGATGTTGATGATGATGATGATGATGATGAGGATGATGATGACGATGACGATGATGA	1
TGATGTTGATGTTGATGATGATGATGATGATGATGATGAGGATGATGACGATGACGAGGATGG	1
TTATGTTGATGTTGATGATGATGATGAAGATGATGATGATGATGATGCCGATGACGATGATGA	1
TGATGTTGATGTTGATGTTGATGATGATGATGATGATGATGATGATGACGATGACGATGATGA	1
TGATGTTGATGTTGATGATGATGATGATGATGATGATGATGATGATGATGACGATGATGA	1
TGATGTTGATGTTGATGTTGATGATGATGATGATGATGATGATGACGATGACGATGATGA	1
TGATGTTGAGGTTGATGATGATGATGATGATGATGATGATGATGATGACGATGACGATGATGA	1
TGATCTTGATGTTGATGATGAGGATGATGATGCTGATGATAATGATGACGATGACGATGATGA	1
TGATGTTGACGTTGATGATGATGATGATGATGATGATGATGATGATGACGATGACGATGATGA	1
TTAAGTTGATGTTGAAGATGATGATGATGATAATGATGATGATGATGACGATGACGATGATGA	1

Length variants:
63	257
54	1
57	4
60	10

