Subpop report generated 10-07-25 18:11:47

fastq:	/mnt/scratch45/sbiam21/all_crypto/bloomine/BlooMine_RUNDIR/SRR10363412_44656/Cp_gp60_IIa/SRR10363412_44656.Cp_gp60_IIa_BMfiltered.fq
flanks_fasta flanks:	/mnt/scratch45/sbiam21/all_crypto/bloomine/BlooMine_RUNDIR/tmp.Cp_gp60_IIa_flanks.fa


Sequence variants:
TGATGTTGATGTTGATGATGATGATGATGATGATGATGATGATGATGACGATGACGATGATGA	127
TGATGTTGATGTTGATGATGATGATGATGATGATGATGATGATGACGATGACGATGATGA	10
TGATGTTGATGTTGATGATGATGATGATAATGATGATGATGATGATGACGATGACGATGATGA	1
TGATGTTGATGTTGATGATGATGATTATGATGATGATGTTGATGATGACGATGACGCTGATGA	1
TGATGTTGATGTTGATGGTGATGATGATGATGATGATGATGATGATGACGATGACGATGATGA	1
TGATGTTGATGTTGATGATGATGATGATGATGATGATGATGATGATGACGATGTCGATGATGA	1
TGATGTTGATGTTGATGATGATGATGATGATGATGATGATGATGATGACGACGACGATGATGA	1
TGATGTTGATGTTGATGATGACGATGACGATGATGA	2
TGATGTTGATGTTGATGATGATGATGATGATGGTGATGATGATGATGACGATGACGATGATGA	1
TGATGTTGATGTTGATGATGATGCTGATGATGATGATGATGATGATGACGATGACGATGATGA	1
TGATGTTGATGTTGATGATGATGATGATTATGATGATGATGATGATGACGATGACGATGATGA	1
TGATGTTGATGTTGATGCTGATGATGATGATGATGATGATGATGATGACGATGACGATGATGA	1
TGATGTTGATGTTGATGATGATGATGATGATCATGATGATGATGATGACGATGACGATGATGA	1
TGATGTTGATGTTGATGATCATGATGATGATGATGATGATGATGATGACGATCACGATGATGA	1
TGATGTTAATGTTGATGATGATGATGATGATGATGATGATGATGATGACGATGACGATGATGA	1
TGATGTTGATGTTGATGATGATGATGCTGATGATGATGATGATGATGACTATGACGATGATGA	1
TGATGTTGCTGTTGATGATGATGATGATGATGATGATGATGATGAGGACGATGACGATGATGA	1

Length variants:
63	141
60	10
36	2

