Subpop report generated 11-07-25 03:01:15

fastq:	/mnt/scratch45/sbiam21/all_crypto/bloomine/BlooMine_RUNDIR/SRR10363466_44547/Cp_gp60_IIa/SRR10363466_44547.Cp_gp60_IIa_BMfiltered.fq
flanks_fasta flanks:	/mnt/scratch45/sbiam21/all_crypto/bloomine/BlooMine_RUNDIR/tmp.Cp_gp60_IIa_flanks.fa


Sequence variants:
TGATGTTGATGATGATGATGATGATGATGATGATGATGATGACGATGACGATGATGA	225
GATGTTGATGATGATGATGATGATGATGATGATGATGATGACGATGACGATGATGA	1
TGATGTTGATGATGATGATGATGATGATGATGATGATGATGACGATGACGCTGATGA	1
TGATGTTGATGATGATGATGATGATGATGATGATGATGCTGACGATGACGATGATGA	1
TGATGTTGATGATGATGATGATGATGATGATGATGATGATGACGATGACGAGGATGA	1
CGATGTTGATGATGATGATGATGATGATGATGATGATGATGACGATGACGATGATGA	1
TGATGTTGATGATGATGATGATGATGATGATGATGATGATGATGACGATGACGATGATGA	1
TGATGTTGATGATGATGATGATGATGATGATGATGATGACGATGACGATGATGA	9
TGGTGTTGATGATGATGATGATGATGATGATGATGATGATGACGATGACGATGATGA	1
TGATGTTGATGATGATGATGATGATGATGATGATGATGATGACGATTACGATGATGA	1
TGATGTTGATGATGATGATGATGATGATGATGATGATGACGACGATGACGATGATGA	1
TGATGTTGATGATGATGATGTTGATGATGATGAGGATGATGACGATGACGATGATGA	1
TGATGTTGATCATGATGATGATGATGATGATGATGATGATGACGATGACGATGATGA	1
TGATGTTGATGATGATGATGATGATGATGATGATGATGATGACGATGAAGATGATGA	1
TGATGATGATGATGATGATGATGATGATGATGATGATGATGACGATGACGATGATGA	1
TGATGTTGATGATGATGATGATGACGATGATGATGATGATGACGATGACGATGATGA	1
TGATGTTGATGATGATGATGATGATGATGATGATGATGATGACGCTGACGATGATGA	1
TGATGGTGATGATGATGATGATGATGATGATGATGATGATGACGATGACGATGATGA	1
TGATGTTGATGATGATGATGATGATGATGATTATGATGATGACGATGATGATGATGA	1
TGATGTTGATAATGATGATGATGATGATGATGATAATGATGACGATGAAGATGACGA	1
TGATGTTGATGATGATGATGATGATGATGTTGATGATGATGACGATGACGATGATGA	1
TGATGTTGATGATGATGATGATGATGATGATGATGGTGATGACGATGACGATGATGA	1
TGATGGTGATGATGATGATGATGATGATGATGATGATGATGGCGATGACGATGATGA	1
TGATGTTGATGATGATGATGATGATGATGAAGATGATGATGACGATGACGATGATGA	1

Length variants:
57	245
56	1
60	1
54	9

