Subpop report generated 01-08-25 12:27:54

fastq:	/home/arthur/BioInf/Crypto_work/fastq/BM_paper_missing/BlooMine_RUNDIR/SRR15694564_11707/Cp_gp60_IId/SRR15694564_11707.Cp_gp60_IId_BMfiltered.fq
flanks_fasta flanks:	/home/arthur/BioInf/Crypto_work/fastq/BM_paper_missing/BlooMine_RUNDIR/tmp.Cp_gp60_IId_flanks.fa


Sequence variants:
TCGATGTTGATGATGATGATGATGACGATGATGATGATGATGATGATGATGATGATGATGATGATGATGA	179
TCGATGTTGATGATGATGATGATGACGATGATGATGATGATGATGATGATGATGATGATGATGATGA	12
TCGATGTGGATGATGATGATGATGACGATGATGATGATGATGATGATGATGATGAGGATGATGGTGATGA	1
TCGATGTTGATGATGATGATGATGACGATGATGATGATGATGATGATGATGATGATGATGATGA	2
TCGATGTTGATGATGATGATGATGACGACGATGATGATGATGATGATGATGATGATGATGATGATGATGA	2
TCGATGTTGATGATGATGATGATGACGATGATGATGATGATGATGATGATGATGATGAGGATGATGATGA	2
TCGATGATGATGATGATGATGATGACGATGATGATGATGATGATGATGATGATGATGATGATGATGATGA	1
TCGATGTTGATGATGATGATGATGATGATGATGATGATGATGATGATGATGATGATGATGATGATGATGA	1
TCGATGTTGATGATGATGATGATGACGATGATGATGATGATGATTATGATGATGATGATGATGATGATGA	1
TCGATGTTGATGATGATGATGATGGCGATGATGATGATGATGATGATGATGATGATGATGATGATGATGA	1
TCGATGTTGATGATGATGATGATGACGATGATGATGATGATGATGATGATGATGATGATGATGATCATGA	1
TCGATGTTGATGATGATGATGATGATGATGATGATGATGATGATGATGATGATGATGATGATGATGAAGC	1
TCGAGGTTGATGATGATGATGATGACGATGATGATGAGGATGATGATGATGATGATGATGATGATGATGA	1
TCGATGTTGATGATGATGATGATGACGATGGTGATGATGATGATGATGATGATGATGATGATGATGATGA	1
TCGATGTTGATGATGATGATGATGACGATGACGATGATGATGATGATGATGATGATGATGATGATGATGA	1
TAGATGTTGATGATGATGATGATGACGATGATGATGATGATGATGATGATGATGATGATGAGGATGATGA	1
TCGATGTTGATGATGATGATGATGACGATGATGATGATGATGATGATGATGATGATGATGATGATGATGATGA	1
TCGATGTTGATGATGATGATGATGACGATGATGATGATGATGATGATGATGATGAGGATCATGATGATGA	1
TAGAGGTTGATGATGATGATGATGACGATGATGATGATGATGATGATGATGAGGATGATGATGATGAGGG	1
TAGATGTTGATGATGATGATGATGACGATGATGATGATGATGATGATGATGATGATGATGATGATGATGA	1
TCGATGTTGCTGATGATGATGATGACGATGATGATGATGATGATGATGATGATGATGATGATGATGATGA	1
CCGATGGTGATAATGATGATGATGACGATGATGATGATGATGATGATGATGATGAGGATGAGGATGATGA	1
TCGATGTTGATGATGATGATGATGACGATGATGGTGATGATGATGATGATGATGATGATGATGATGATGA	1
TCGATGTTGATGATGATGATGATGACGATGATAATGATGATGATGATGATGATGATGATGATGATGATGA	1
TCGATGTTGATGATGATGATGATGACGATGATGATGATGATGATGATGATGATGATGATGATGATGATTA	1

Length variants:
70	202
67	12
64	2
73	1

