Subpop report generated 01-08-25 02:01:37

fastq:	/home/arthur/BioInf/Crypto_work/fastq/BM_paper_missing/BlooMine_RUNDIR/SRR15694511_44412/Cp_gp60_IIa/SRR15694511_44412.Cp_gp60_IIa_BMfiltered.fq
flanks_fasta flanks:	/home/arthur/BioInf/Crypto_work/fastq/BM_paper_missing/BlooMine_RUNDIR/tmp.Cp_gp60_IIa_flanks.fa


Sequence variants:
TGATGTTGATGATGATGATGATGATGATGATGATGATGATGATGACGATGATGA	235
TGATGTTGATGATGATGATGATGATGATGCTGATGATGATTATGACGATGATGA	1
TGATGTTGATGATGATGTTGATGATGATGATGATGATGATGATGACGATGATGA	1
TGATGTTGATGATGATGATGATGATGATGCTGATGATGATGATGACGATGATGA	1
TGATGTTGATGATGATGATGATGATGATGATGATGATGATGACGATGATGA	12
TGATGTTGTTGATGATGATGATGATGATGATGATGATGATGATGACGATGATGA	1
TGATGTTGATGAGGATGATGATGATGATGATGATGATGATGATGACGATGATGA	1
TGATGTTGATGATGATGATGATGATGATGATGATTATGATGACGATGATGA	1
CGATGCTGATGATGATGATGATGATGATGATGATGATGATGATGACGATGATGA	1
TGATGTCGATGATGATGATGATGATGATGATGATGATGATGATGACGATGATGA	1
TGATGTTGATGACGATGATGATGATGATGACGATGATGATGATGACGATGATGA	1
TGATGTTGATGATGATGATGATGTTGATGATGATGATGATGTTGACGATGATGA	1
TGATGTTGATGATGTTGATGATGATGATGATGATGATGATGATGACGATGATGA	1
TGATGTTGATGATGATGATGATGATGATGATGATGATGATGATGACGATGATAA	1
TGATGGTGATGATGATGATGATGATGATGATGATGATGATGATGGCGATGATGA	1
TGATGTTGATGATGATGATGATGATGATGATGATGATGATGATGACGAAGATGA	1
TGATGTGGATGATGATGATGATGATGATGATGATGATGATGATGACGATGATGA	1
TGAGGTTGTTGATGATGATGATGAGGTTGATGATGATGATGATGACGATGATGA	1
TGATGTTGATGATGATGATGATGATGATGATGATGATGATGATGACGATGCTGA	1
TGATGTTGATGATGATGATGACGATGATGATGATGATGATGATGACGATGATGA	1
TGATGTTGATGATAATGATGATGATGATGATGATGATGATGATGACGATGATGA	1
TGATGTTGAAGATGATGAAGATGATGATGATGATGATGATGATGACGTTGATGA	1
TGATGTTGATGATGATGCTGCTGATGATGATCATGATGATGATGGCGATGATGG	1
TGCTGTTGATGATGTTAATGATGAGGATGATGTTGTTGATGATGACGATGATGA	1
TGATGTTGATGATGATGATGAGGATGATGATGATGATGATGATGACGATGATGA	1
TGATGTTGATGATGATGATGATGATGTTGATGATGATGATGATGACGATTATGA	1
TGATGTTGATTATGATGTTGACGTTGATGATGATGATGATGACGACGATGATGC	1
TGATGTTGATGATGCTGCTGACGATGATGATGATGATGCTGATGACGATGATGA	1
TGATGTTGATGATGAAGATGATGATGATGATGATGATGATGATGACGATGATGA	1

Length variants:
54	261
51	13

