Subpop report generated 11-07-25 01:08:41

fastq:	/mnt/scratch45/sbiam21/all_crypto/bloomine/BlooMine_RUNDIR/SRR10363447_44582/Cp_gp60_IIa/SRR10363447_44582.Cp_gp60_IIa_BMfiltered.fq
flanks_fasta flanks:	/mnt/scratch45/sbiam21/all_crypto/bloomine/BlooMine_RUNDIR/tmp.Cp_gp60_IIa_flanks.fa


Sequence variants:
TGATGTTGATGTTGATGTTGATGATGATGATGATGATGATGATGATGATGATGACGATGACGATGATGA	105
TGATGTTGATGTTGATGTTGATGATGATGATGATGATGATGATGATGATGACGATGACGATGATGA	3
TGATGTTGATGTTGATGTTGATGATGATGATGATGATGATGATGATGATGATGACGAGGACGATGATGA	1
TGATGTTGATGTTGTTGTTGATGAGGATGATGATGATGATGATGATGATGATGACGATGACGATGATGA	1
TGATGTTGATGTTGATGTTGATGATGATGATGATGATGATGATGATGATGATGACGATGACGGTGATGA	1
TGATGTTGATGTTGATGTTGATGATGATGATCATGATGATGATGATTATGATGACGATGACGATGATGA	1
TGATGTTGATGTTGATGTTGATGATGATGATGATGATGATGCTGATGATGATGACGATGACGATGATGA	1
TGTTGTTGATGATGATGATGATGCTGATGATGATGATGATGATGACGATGACGATGATGA	1
TGATGTTGATGTTGATGTTGTTGATGATGATGCAGATGATGATGATGCTGATGATGATGAAGATGATGA	1
TGATGTTGATGTTGATGTTGATGATGAGGATGATGATGATGATGATGATGATGACGATGACGATGATGA	1
TGATGTTGATGTTGATGTTGATGATGATGATGATGATGATGATGATGACGATGACGATGATGA	1
TGATGATCATGTTGATGTTGATGATGAAGATGATGATGATGATGATGATGATGACGATGACGATGAAGA	1
TGATGTTGATGTTGATGTTGATGATGATGATGATGATGATGATGATGATGATGACGATGATGATGATGA	1
TGATGTTGATGTTGATGTTGTTGATGATGATGATGATGATGATGATGATGATGACGATGACGATGATGA	1
TGATGTTGATGTTGATGTTGATGATGATGATGATGATGATGATGATGATGATGACGATGACGCTGATGA	1

Length variants:
69	116
66	3
60	1
63	1

