Subpop report generated 01-08-25 03:07:25

fastq:	/home/arthur/BioInf/Crypto_work/fastq/BM_paper_missing/BlooMine_RUNDIR/SRR15694545_42632/Cp_gp60_IId/SRR15694545_42632.Cp_gp60_IId_BMfiltered.fq
flanks_fasta flanks:	/home/arthur/BioInf/Crypto_work/fastq/BM_paper_missing/BlooMine_RUNDIR/tmp.Cp_gp60_IId_flanks.fa


Sequence variants:
TCGATGTTGATGATGATGATGATGACGATGATGATGATGATGATGATGATGATGATGATGATGATGA	87
TCGATGTTGATGATGATGATGATGACGATGATGATGATGATGATGATGATGATGATGATGA	1
TCGATGTTGATGATGATGATGATGACGATGATGATGATGATGATGATGATGATGATGATGATGA	6
TCGATGTTGATGATGATGATGACGATGATGATGATGATGATGATGATGATGATGATGATGATGA	1
TCGATGTTGAGGATGATGATGTTGTCGATGATGATGATGATGATGATGATGATGATGATGATGATGA	1
TCGATGTTGATGATGATGATGATGACGATGATGATGATGATGATGATGATGATGATGCTGATGA	1
TCGATGTTGATGATGATGATGATGACGATGATGATGATGTTGATGATGATGATGATGATGATGATGA	1
TCGATGTTGATGATGATGATGATGACGATGATGATGATGATGATGATGATGATGATGATGATGG	1
TCGATGTTGATGATGATGATGATGACGATGATGATGAAGATGATGATGATGATGATGATGATGATGA	1
TCAATGTTGATGATGATGATGATGACGATGATGATGATGATGATGATGATGATGATGATGATGATGA	1
TCGCTGTTGATGATGATGATGATGACGATGATGATGATGATGATGATGATGATGATGATGATGATGT	1
TCGATGTTGATGATGATGATGATGACGATGATGATGATGATGATGACGATGATGATGATGATGATGA	1

Length variants:
67	93
61	1
64	9

