Subpop report generated 10-07-25 15:23:01

fastq:	/mnt/scratch45/sbiam21/all_crypto/bloomine/BlooMine_RUNDIR/SRR10363395_44871/Cp_gp60_IIa/SRR10363395_44871.Cp_gp60_IIa_BMfiltered.fq
flanks_fasta flanks:	/mnt/scratch45/sbiam21/all_crypto/bloomine/BlooMine_RUNDIR/tmp.Cp_gp60_IIa_flanks.fa


Sequence variants:
TGATGTTGATGATGATGATGATGATGATGATGATGATGATGACGATGACGATGATGA	287
TGATGTTGATGATGATGATGATGATGATGATGATGATGACGATGACGATGATGA	10
TGATGTTGATGATGGTGATGATGATGATGATGATGATGATGACGATGACGATGATGA	1
TGATGTTGATGATGATGATGATGATGATGATGATGATGATGACGTTGACGATGATGA	1
TGATGTTGATGATGATGATGATGATGATGATGATGACGATGACGATGATGA	1
TGATGTTGATGATGATGATGATAATGATGATGATGATTACGATGACGATGATGA	1
TGATGTTGATGATGATGATGATGATGATGATGATGATGATGATGACGATGACGATGATGA	1
TGATGTTGATGATGATGAGGATGATGATGATGATGATGATGACGATGACGATGATGA	1
TGATGTTGATGATGATGATGATCATGATGATGATGATGATGACGATGACGATGATGA	1
TGATGTTGATGATGATGATGATGATGATGATGATGATGATGACGATGACGATGAGGA	1
TGATGTTGTTGATGATGATGATGATGATGATGATGATGATGACGATGACGATGATGA	2
TGATGTGGAGGATGATGAGGATGATGAGGATGATGATGATGACGATGACGATGATGA	1
TGATGTTGATGATGATGATGATGATGATGATGTTGATGATGACGATGACGATGATGA	1
TGATGTGGATGATGATGATGATGATGATGATGATGATGATGACGATGACGATGATGA	1
TGGTGTTGATGATGATGATGATGATGATGATGATGATGATGACGATGACGATGATGA	1
TGATGTTGATGCTGCTGGTGATGATGATGATGATGATGATGACGATGACGATGATGA	1
TGATGTTGATGATGATGATGATGATGATGATGATGATGATGATGATGACGATGATGA	1
TGATGTTGATGATGATGATGATGATGATGATGATGATGATGACAATGACGATGATGA	1
TGATGTTGATGATGATGTTGATGATGATGATGATGATGATGACGATGACGATGATGA	2
TAATGTTGATGATGATGTTGATGATGTTGATGATGATGATGCCAATGATGATGATGA	1
TGATGTTGATGATGATGATGATGATGATGATGCTGATGATGACGATGACGATGATGA	1
TGATGTTGATGATGATGATGATGATGATGATGATGATGATGTCGATGACGATGATGA	2
TGAGGTTGAGGATGATGATACGGATGAGGATGAGGTTAAGGACATGGCCGATGATGA	1
TGCTGTTGATGAGGATGATGAAGATGATGAAGATGGTGATGACGCTGACGATGGTGA	1
TGATGTTGATGATGATGATGTTGATGATGATGATGAGGATGACGAGGACGATGATGA	1
TGATGATGATGATGATGATGATGATGATGATGATGATGATGACGATGACGAGGATGA	1
TGATGTTGATGATGATGATGAGGATGATGATGATGATGATGACGATGACGATGATGA	1
TGATGTTGATGATGATGATGATGATGATGATGATTATGATGACAATGACGATGATGA	1
TGATGTTGATGATGATGATGATGATGATGATGATGATGATGACGATGACGATGATGC	1
TGAAGTTGATGATGATGATGATGATTATGATGATGATGATGACGATGACGATGATGA	1
TGATGTTGATGATGATGATGATGATGATGATGATGATGATGACGATGATGATGATGA	1
TGATGTTGATGATGATGATGATGATGATGATGATGATGATGACGATGAAGATGATGA	1
AGATGTTGATGATGATGATGATGATGATGATGATGATGATGACGATGACGATGATGA	1
TGATGTTGATGATGATGATGATGATGATGATGATGATGATGACGACGACGATGATGA	1
TGATGTTGATGATGATGATGTTGATGTTGATGATGATGATGACGATGACGATGATAA	1
TGATGTTGATGATGAGGATGATGATGATGATGATGATGATGACGATGACGATGATGA	1
TGATGTTGATGATGATGATGATGATGATGATGATGATTATGACGATGACGATGATGA	1
TGATGTTGATGATGATGATGGTGATGATGATGATGATGATGCCGATGACGATGATGA	1
TGATGTTGATGATGAGGATGATGAGGATGATGATGAAGATGACGATAACGATGATGT	1

Length variants:
57	324
54	11
51	1
60	1

