Subpop report generated 01-08-25 06:12:28

fastq:	/home/arthur/BioInf/Crypto_work/fastq/BM_paper_missing/BlooMine_RUNDIR/SRR15694573_45011/Cp_gp60_IId/SRR15694573_45011.Cp_gp60_IId_BMfiltered.fq
flanks_fasta flanks:	/home/arthur/BioInf/Crypto_work/fastq/BM_paper_missing/BlooMine_RUNDIR/tmp.Cp_gp60_IId_flanks.fa


Sequence variants:
TCGATGTTGATGATGATGATGATGACGATGATGATGATGATGATGATGATGATGATGATGATGATGA	125
TCGATGTTGATGATGATGATGATGACGATGATGATGATGATGATGATGATGATGATGATGATGA	6
TCGATGTTGATGATGATGATGATGACGATGATGATGATGACGATGATGATGATGATGATGATGATGA	1
TCGATGTTGATGATGATGATGATGTCGATGATGATGATGATGATGATGATGATGATGATGATGATGA	1
TCGATGTTGATGATGATGATGATGACGATGATGATGATGATGATGATGATGATGATGATGATGATGATGA	2
TCGATGTTGATGATGTTGATGATGACGATGATGATGATGATGATGATGATGATGATGATGATGATGA	1
TCGATGTTGATGATGATGATGATGATGATGATGATGATGATGATGATGATGATGATGATGATGATGA	1
TCGATGTTGATGATGATGATGATGACGATGATGATGACGATGATGATGATGATGATGATGATGATGA	2
TCGATGTTGATGATGATGATGATGACGATGATGATGAGGATGATGATGATGATGATGATGATGATGA	1
TCGATGTTGATGATGATGATGATGACGATGCTGACGATGATGATGATGATGATGATGATGGTGATGA	1
TCGATGTGGATGATGATGATGATGACGATGATGATGATGATGATGATGATGATGATGATGATGATGA	1
TCGATGTTGATGATGAGTATGATGACGATGATGATGATGATGATGACGATGATGATGATGATGATGA	1
TCGATGTAGATGATGATGATGATGGCGATGATGATGATGATGATGAAGATGAAGATGTTGAGGATGA	1
TCGATGTTGATGATGATGATGATGACGATGATGATGATGATGATGATTAGGATGATGATGATGATGA	1
TCGATGTTGATGATGATGATGATGACGGCGATGATGATGATGATGATGATGATGATGATGATGATGA	1
ACGCCGTTGATGATGATGATTATGACGATGATGATTATGATGATGATGATGATGATGATGATGATGA	1
TCGATGTTGATGATGATGATGATGACGATGATGATGATGATGATGATGATGATGATGATGA	1
TCGATGTTGATGATGATGATGATGACGACGATGATGATGATGATGATGATGATGATGATGATGATGA	1
TCGATGTTTAAGATGATGATGATGACGATGATGATGATGATGATGATGATGATGATGATGATGATGA	1
TCGATGATCATGATGATGATGATGACGATGATGCTGATGATGATGATGCTGATGATGATGATGATGA	1

Length variants:
67	142
64	6
70	2
61	1

