Subpop report generated 01-08-25 13:44:16

fastq:	/home/arthur/BioInf/Crypto_work/fastq/BM_paper_missing/BlooMine_RUNDIR/SRR15694558_11744/Cp_gp60_IId/SRR15694558_11744.Cp_gp60_IId_BMfiltered.fq
flanks_fasta flanks:	/home/arthur/BioInf/Crypto_work/fastq/BM_paper_missing/BlooMine_RUNDIR/tmp.Cp_gp60_IId_flanks.fa


Sequence variants:
TCGATGTTGATGATGATGATGATGACGATGATGATGATGATGATGATGATGATGATGATTATGATGATTA	1
TCGATGTTGATGATGATGATGATGACGATGATGATGATGATGATGATGATGATGATGATGATGATGATGA	51
TCGATGTTGATGATGATGATGATGACGATGATGATGATGATGATGATGATGATGATGATGATGATTATGA	1
TCGATGTTGATGATGATGATGATGACGATGATGATGATGATGATGATGATGATGATGATGATGATGAGGA	1
TCGATGTTGATGATGATGATGATGACGATGATGATGATGATGATGATGATGATGCTGATGAGGATGATGA	1
TCGATGTTGATGATGATGATGATGACGATGATGATGATGATGATGATGATGATGATGAGGCTGATGATGA	1
TCGATGTTGATGATGATGATGATGACGATGATGATGATGATGATGATGATGATGATGAAGATGATGATGA	1
TCGATGTTGATGATGTTGATGATGACGATGATGATGATGATGATGATGATGATGATGATGATGATGATGA	1
TCGATGTTGATGATGATGATGATGACGATTATGATGATGATGATTATGATTATGATGATTATGATGATGA	1
TCGATGTTGATGATGATGATGATGACGATGATGATGATGATGATGATGAAGATGATGATGATGATGATGA	1
TCGATGTTGATGATGATGATGATGACGATGATGATGATGATGATGATGATGATGATGATGAGGATGATGA	1
TCGATGTTGATGATGATGATGATGACGATGATGATGATTATTATGATGATGATTATGATGATGATGATGA	1
TAGATGTTGATTATGATGATGATGACGATGATGATGATGAAGATGATGATGATGATGATGATGATGATGA	1
TCGATGTTGATGATGATGATGATGACGATGATGATGATGATGATGATGATGATGAGGATGATGATGATGA	1
TCGATGTTGATGATGATGATGATGACGATGATGATGATGATGATGATGATGATGATGATGATGATGA	3
TCGATGTTGATGATGATGATGATGACGATGATGATGATGATGATGATGAGGATGATGATGATGAGGATGA	1
TCGATGTTGATGATGATGATGATGACGATGATGATGATGATGATGATGATGATGATGATGATGATGATCA	1
TCGATGTTGATGATGATGATGATGACGATGATGATGATGATGATGATGATGATGATGATGATGATGATTA	1
TCGATGTTGATGATGATTATGATGACGATGATGATGATGATGATGATGATGATGATGATGATGATGATGA	1
TCGATGTTGATGAAGATGATGATTACGAAGATGATGATGATGATGATTATGATGATTATGATTATTATGA	1
TCGATGTTGATGATGATGATGATGACGATGATGATGATGATGATGATGATGATGATGAGGATGATGATGA	1
TCGCTGTTGATGATGATGATGATGACGATGATGATGATGATGATGATGATGATGATGATGCTGCTGATGA	1
TCGATGTTGATGATGATGATGATGACGATGATGATGATGATGATTATTATGATGATTATGATGATGATGA	1
TAGATGTTGATGATGATGATGATGACGATGATGATGATGATGATGATGATGATGATGATGATGATGATGA	2
TCGATGTTGATGATGATGATGATGACGATGATGATGATGATGATGATGATGATGATGATGCTGATGATGA	2
TCGATGTTGATGATGATGATGATGACGATGATTATGATGATGATGATGATTATTATGATGATGATGATGA	1
TCGATGTTGATGATGATGATGATGACGATGATGATGATGATGATGAGGATGATGATGAGGATGATGATGA	1
TCGATGTTGATGAAGATGATGATGACGATGATGATGATGATGATGATGATGATTATTATGATGATGATGA	1
TCGATGTTGATGATGATGTTGATGACGATGATGATGATGATGATGATGATGATGATGATGATGATGATGA	1
TCGATGTTGATGATGATTATGATGAAGTTGATTATGATGATGATGATGTTGATGATGATGATGATGATGA	1
TCGATGGTGATGATGATGATGATGACGATGATGATGATGATGATGATGATGATGATGATGATGATGATGA	1
TCGTTGTTGCTGATGATGATGATGAAGATGATGATGATGATGATGCTGCTGATGATGATGATGATGAAGA	1
TCGATGTTGATGAGGATGATGATGACGATGATGATGATGATGATGATGAAGATGATGATGACGATGACGA	1
TCGATGTTGATGATGATGATGATGACGATGATGATGATGATGATGATGATGATGATGATGACGATGATGA	1
TCGATGTTGATGATGATGATGATGACGATGATGATGATGATGATGATGATGATTATGATGATGATGATGA	1
TCGATGTTGATGATGATGATGATGACGATGATGATGATGAGGATGATGATGATGATGATGATGATGATGA	1
TCGATGTTGATGATGATGATGCTGACGATGATGATGATGATGATGATGATGATGATGATGATGATGATGA	1
TCGATGTTGATGATGATGATGATGACGCTGATGCTGAGGATGATGATGATGCTGATGCTGCTGATGATGC	1

Length variants:
70	89
67	3

