Subpop report generated 12-07-25 10:17:40

fastq:	/mnt/scratch45/sbiam21/all_crypto/bloomine/BlooMine_RUNDIR/SRR10363562_43006/Cp_gp60_IIa/SRR10363562_43006.Cp_gp60_IIa_BMfiltered.fq
flanks_fasta flanks:	/mnt/scratch45/sbiam21/all_crypto/bloomine/BlooMine_RUNDIR/tmp.Cp_gp60_IIa_flanks.fa


Sequence variants:
TGATGTTGATGATGATGATGATGATGATGATGATGATGATGACGATGACGATGATGA	237
TGATGTTGATGATGATGATGATGATGATGATGATGATGACGATGACGATGATGA	11
TGATGTTGATGATGATGATGATGATGATGATGATGATGATGATGACGATGACGATGATGA	3
TGATGATGATGATGATGATGATGATGATGATGATGATGATGACGATGACGATGATGA	1
TGATGTTGATGATGATGATGATGATGATGATGATGATGATGACGATGACGATGATGG	1
TGATGTTGCTGATGATGATGATGATGATGAAGATGATGATGACGATGACGATGATGA	1
TGATGTTGATCATGCTGATGATGATGATGATGATGATGATGACGATGACGATGATGA	1
TGATGTAGATGATGATGATGATGATGATGATGATGATGATGACGATGACGATGATGA	1
TGATGTTGATGATGATGATGATGATGATGATGATGATGATGACGATGACGATCATCA	1
TGATGTTGCTGATGATGATGATGATGATGATGATGATGATGACGATGACGATGATGA	1
TGATGTTGATGATGATGATGATGATGATGATGATGATGATTACGATGACGATGATGA	1
TGATGTTGATGATGATGATGATGATGATGATGATGATGATGACGATGATGA	1
TGATGTTGATGTTGATGATGATGATGATGATGATGATGATGACGATGACGATGATGA	1
TGATGTTGGTGATGATGATGATGATGATGATGATGATGATGACGATGACGATGATGA	1
TGATGTTGATGATGATGATGATGATGACGATGGTGATGATGACGATGACGATGATGC	1
TGATGTTGATGATGATGCTGATGATGATGATGATGATGATGACGATGACGATGATGA	1
TGATGTTGAGGATGATGATGATGATGATGATGATGATGATGACGATGACGATGATGA	1
TGATGTTGATGATGATGATGATGATGATGATGATGTTGTTGACGAGGACGATGATGA	1
TGATGTTGATGATGATGATGATGATGATGATGATGATGATGACGATGACGATGATGC	1
TGATGTTGTTGTAGATGATGATGATGATGATGCTGATGATGACGATGACGATGATGA	1
TGATGTTGATGATGATGATGATGATGATGATGATGATGATGACGATGTCGATGATGA	1
TGATGTTGATGATGATGATGATGATGATGATGATGATGATGACGATGCCGATGATGA	1
TGATGGTGATGATGATGATGATGATGATGATGATGATGATGACGATGACGATGATGA	1
AGGGGTTGATGATGATGATGATGATGAGGAGGATGATGATGGCGATGACGATGATGA	1
TGATGTTTATGATGATGATGATGATGATGATGATGATGATGACGATGACGATGATGA	1
TGATGTTGATGATTATGATGATGATGATGATGATGATGATGACGATGACGATGATGA	1
TGATGTTGATGATGATGATGATGACGATGATGATGATGATGACGATGACGATGATGA	1
TGATGTTGATGATGATGATGATAATGATGATGATGATGATGACGATGACGATGATGA	1
TGATGTTGATGATGATGATGATGCTGATGATGATGATGATGACGATGACGATGATGA	1
TGATGTTGATGATGAGGATGATGATGATGATGATGATGTTGACGATGACGATGATGA	1

Length variants:
57	263
54	11
60	3
51	1

