Subpop report generated 10-07-25 07:38:29

fastq:	/mnt/scratch45/sbiam21/all_crypto/bloomine/BlooMine_RUNDIR/SRR10363317_42565/Cp_gp60_IIa/SRR10363317_42565.Cp_gp60_IIa_BMfiltered.fq
flanks_fasta flanks:	/mnt/scratch45/sbiam21/all_crypto/bloomine/BlooMine_RUNDIR/tmp.Cp_gp60_IIa_flanks.fa


Sequence variants:
TGATGTTGATGATGATGATGATGATGATGATGATGATGATGACGATGACGATGATGA	224
TGATGTTGATGATGATGATGATGATGATGATGATGATGACGATGACGATGATGA	10
TGATGTTGATGATGATGATGATGATGACGATGATGATGATGACGATGACGATGATGA	1
TGATGTTGATGATGAGGATGATGATGATGATGATGATGATGACGATGACGATGATGA	1
TGATGTTGATGATGATGATGATGATGATGATGATGATGATGACGATGATGA	1
TGATGTTGGTGATGATGATGATGAGGATGATGATGATGATGACGATGACGATGATGA	1
TGATGTTGATGATGATGATGATGATGATGATGATGATGCTGACGATGACGATGAGGA	1
TGATGTTGATGATGATGATGATGATGATGATTATGATGATGACGATGACGATGATGA	1
TGATGTTGATGATGATGATGATGATGATGATGAGGATGACGACGACGATGATGA	1
TGATGTTGATGATGACGATGATGATGATGATGATGATGATGACGATGACGATGATGA	1
TGATGATGATGATGATATTGATGATGATGATGACGATAATTACGATGACGATGATGA	1
TGTTGTTGATGCTGATGATGATGATGATGATGATGATGATGACGATTACGATGATGA	1
TGATGTTGATGATGATGATGATGATGATGATGATGATGATGATGACGATGACGATGATGA	1
TGATGTTGATGATGATGATGATGATGATGATGATGATGATGACGATGATGATGATGA	1
TGATGTTGATGATGATGATGATGATGAGGATGATGATGATGACGATGACGATGATGA	1
TGATGTGGATGATGATGATGATGATGATGATGATGATGATGACGATGACGATGATGA	1
TGATGTTGATGATGATGATGATGAGGATGATGATGATGATGTCGATGACGATGATGA	1
TGATGTTAATGATGATGATGATGATGATGATGATGATGGTGACGATAACGATGATGA	1
TGATGTTGATGATGATGATGATGATGATGATGATGATGATGACGATGACGACGATGA	1
TGATGTTGATGATGATGATGAAGATGATGATGATGATGATGACGATGACGATGATGA	1
TGATGTTGATGATAATGTTGATGATGATGATGATGAAGATGACGATGACGTTGATGC	1
TGATGTTGATGATGATGATGATGATGATGATGATGATGAAGACGATGACGATGATGA	1
TGATGTTGATGATGATGCTGATGATGATGATGATGATGATGACGATGACGATGATGA	2
TGATGTTGATGATGATGATGATGATGATGATGATGATGATGACGATGACGCTGATGA	1
TGAGGTTGATGATGATGATGATGATGATGATGATGATGATGACGATGACGATGATGA	1
TGCTGCTGATGATGATGATGATGATGATGATGATGATGATGACGATGACGATGATGA	1
TGATGTTGATGATGATGATGATGATGCTGATGATGATGAAGACGACGACGATGATGA	1
TGATGTTGATGCTGATGATGATGATGATGATGATGATGATGACGATGACGATGATGA	1
TGATGTTGATGATGATGAGGATGATGATGATGATGATGATGACGATGACGATGATGA	1
TGATGTTGCTGCTGATGATGATGATGATGATGATGATGATGACGATGACGATGATGA	1
TGATGTTGATGATGTTGATGATGATGATGATGATGATGATGACGATGACGATGATGT	1
AGATGTTGATGATGATGAGGATGATGATGATGATGATGATGACGATGACGATGATGA	1
TGATGTTGATGATGATGATGATGATGATGAGGATGATGATGACGATGACGATGATGA	1
TGATGCTGATGATGATGATGATGATGATGATGATGATGATGACGATGACGATGATGA	1
TGATGTTGATGATGATGATGCTGATGATGATGATGATGATGACGATGACGATGATGA	1
TGATGTTGAGGATGATGATGATGATGATGATGATGATGATGACGATGACGATGATGA	1
TGATGTTGATGATGATGATGGTGATGATGATGAAGATGATGACGATGACGATGATGA	1
TGATGTTGATGATGATGATGATGATGTTGATGATGATGATGACGATGACGATGATGA	1
TGATGTTGATGATGATGATGATGATGATGATGATGATGATGACGATGACGATGTTGA	1

Length variants:
57	259
54	11
51	1
60	1

