Subpop report generated 11-07-25 01:36:33

fastq:	/mnt/scratch45/sbiam21/all_crypto/bloomine/BlooMine_RUNDIR/SRR10363450_44577/Cp_gp60_IIa/SRR10363450_44577.Cp_gp60_IIa_BMfiltered.fq
flanks_fasta flanks:	/mnt/scratch45/sbiam21/all_crypto/bloomine/BlooMine_RUNDIR/tmp.Cp_gp60_IIa_flanks.fa


Sequence variants:
TGATGTTGATGATGATGATGATGATGATGATGATGATGATGACGATGACGATGACGATGACGATGATGA	116
TGATGTTGATGATGATGATGATGATGATGATGATGATGATGACGACGACGATGACGATGACGATGATGA	2
TGATGTCGATGATGATGATGATGATGATGATGATGATGATGACGATCACGATGACGATGACGATGATGA	1
TGATGTTGATGATGATGATGATGATGATGATGATGACGATGACGATGACGATGACGATGATGA	1
TGATGTTGATGATGATGATGATGATGATGATGATGATGATGATGACGATGACGATGACGATGACGATGATGA	1
TGATGTTGATGATGATGATGATGATGATGATGATGATGACGATGACGATGACGATGACGATGATGA	8
TGATGTTGATGATGATGATGATGATGATGATGATGAGGATGACGATGACGATGACGATGACGATGATGA	1
TGATGTTGATGATGATGTTGATGATGATGATGACGATGATGACGATGACGATGACGATGACGATGAAGA	1
TGATGTTGATGATGATGATGATGATGATGATCATGATGATGACGATGACGATGACGATGACGATGATGA	1
TGATGTTGATGATGATGATGATGATGACGATGATGATGATGACGATGACGATGACGATGACGATGATGA	1
TGATGTTGATGATGATGATGATGATGATGATGATGATGACGACGATGACGATGACGATGACGATGATGA	1
TGATGTTGATGATGATGATGATGATGATGATGATGCTGATGACGATGACGATGACGATGACGATGATGA	1
TGATTGTGACGATGATGATGATGTTGATGACGACGCTTATGAAGATGAAGATGTCGTTGACGATGTTGA	1
TGATGTTGATGCTGATGATGATGATGATGATGATGATGATGACGATGACGATGACGATGACGATGATGA	1
TGATGTTGATGATGATGATGATGATGATGATGATGATGATGACGAGGACGAAGACGATGACGATGATGA	1
TGATGTTGATGATGATGATGATGATGAGGATGATGATGATGACGATGACGATGACGATGACGATGATGA	1
TGATGTTGATGATGATGATGATGATGATGATGATGATGATGACGCTGACGATGACGATGACGATGATGA	1
TGATGTTGATCATGATGATGATGATGATGATGATGATGATGACGATGACGATGACGATGACGATGATGA	1
TGATGTTGATGATGATGATGATGATGATGATGATGATGATGACGATCACGATGACGATGACGATGATGA	1
TGATGTTGATGATGATGATGATGATGATGATGATGATGATGACGATGACGATGACGATGACGGTGATGA	1
TGATGTTGATGATGATGATGATGATGATGATGATGATGATGACGATGACGATGACGATGACGATGAGGA	1
TGATTTTGTTGATGATGATGATGATGATGATGATGATGATGACGATGACGATGACGATGACGATGATGA	1
TGATGTTGATGATGATGATGATTATCATGATGCTGATGATGACGATGACGTTGACGATGAGGATGATGA	1
TGATTTTGATGATGATGATGATGATGATGATGATGATGATGACGATGACGATGACGATGACGATGATGA	1

Length variants:
69	137
63	1
72	1
66	8

