Subpop report generated 01-08-25 15:47:07

fastq:	/home/arthur/BioInf/Crypto_work/fastq/BM_paper_missing/BlooMine_RUNDIR/SRR15694510_44425/Cp_gp60_IIa/SRR15694510_44425.Cp_gp60_IIa_BMfiltered.fq
flanks_fasta flanks:	/home/arthur/BioInf/Crypto_work/fastq/BM_paper_missing/BlooMine_RUNDIR/tmp.Cp_gp60_IIa_flanks.fa


Sequence variants:
TGATGTTGATGATGATGATGATGATGATGATGATGATGATGATGACGATGATGA	135
TGATGTTGATGATGATGATGATGATGATGATGATGATGATGACGATGATGA	6
TGATGTTGATGATGAGGATGATGATGATGATGATGATGATGATGACGATGATGA	1
TGATGTTGATGATGATGATGATGATGATGACGATGATGATGACGATGATGA	1
TGATGTTGATGATGATGATGATGATGATGATGATGATGATGATGACGAGGATGA	2
TGATGTTGATGATAATGATGATGATGATGATGATGATGATGATGACGATGATGA	1
TGATGCTGATGATGATGATGATGATGATGATGATGATGATGATGACGATGATGA	1
TGATGTTGATGATGATGATGATGATGATGATGATGAGGATGATGACGATGATGA	1
TGATGTTGATGATGATGATGATGATGATGATGATGATGATGATGATGACGATGATGA	1
TGATGTGGATGATGATGATGATGATGATGATGATGATGAAGATGACGATGATGA	1
TGATGTTGATGATGATGATGATGATGATGATGATGATGATGATGACGATGGTGA	1
TGAGGTTGCGGATGATGATGATGATGATGATGATTATGATGATTATGATGATGA	1
TGATCTTGATGATGATGATGATGCTGATGATGATGATGATGATGACGATGATGA	1
TGATGATGATGATGATGATGATGATGATGATGATGATGATGATGACGATGATGA	1
TGCTGTTGATGCTGATGATGATGATGATGAAGATGATGATGACGATGATGA	1
TGATGTTGTTGATGATGATGATGATGATGATGATGATGAAGACGATGATGA	1
TGATGTTGATGATGATGATGATGATGATGATGATGATGAGGATGACGATGATGA	1
TGATGTTGATGATGATGATGATGATGATGATGATGATGACGATGATGA	2
TGATGTTGATGATGATGAGGATGATGATGATGATGATGATGATGACGATGATGA	1
TGATGTTGATGATGATGATGATGATGATGATGATGATGATGAGGACGATGATGA	1

Length variants:
54	149
51	9
57	1
48	2

