Subpop report generated 01-08-25 10:43:10

fastq:	/home/arthur/BioInf/Crypto_work/fastq/BM_paper_missing/BlooMine_RUNDIR/SRR11516703_Bunchgrass/Cp_gp60_IIa/SRR11516703_Bunchgrass.Cp_gp60_IIa_BMfiltered.fq
flanks_fasta flanks:	/home/arthur/BioInf/Crypto_work/fastq/BM_paper_missing/BlooMine_RUNDIR/tmp.Cp_gp60_IIa_flanks.fa


Sequence variants:
TGATGTTGATGATGATGATGATGATGATGATGATGATGATGATGATGACGATGACGATGACGATGATGA	3
TGATGTTGATGATGATGATGATGATGATGATGATGATGATGATGATGACGATGACGATGATGA	138
TGATGTTGATGATGCTGATGATGCTGATGATGATGCTGATGATGCTGACGATGACGATGATGA	1
TGATGTTGATGATGATGATGATGATGATGATGATGATGATGATGACGATGACGATGATGA	16
TGATGTTGATGATGATGAAGATGATGATGAGGAAAATGATGATGACGATGACGATGAAGG	1
TGATGTTGCGGATGATGATGATGATGATGATGATGATGATGATGACGACGTGGACGGTGATGA	1
TGATGTTGATGATGATGATGATGATGCTGATGATGATGATGATGACGATGACGAAGATGA	1
TGATGTTGATGATGATGATGATGATGATGATGATGATGATGACGATGACGATGATGA	25
CGATGTTGATGATGATGATGATGATGATGATGATGATGATGATGATGATGACGATGACGATGATGA	1
TGCTGTTGATGATGATGCTGATGATGATGATGGTGATGATGACGATGATGATGATGA	1
TGATGTTGATGATGATGATGATGATGATGATGATTATGAAGATGATGACGATGACGATGATGA	1
TGATGTTGATGATGATGATGATGATGATGATGATGATGATGATGATGATGACGATGACGATGATGA	9
TGATGGTGATGATGATGATGATGATGATGATGATGATGATGATGACGATGACGATGATGA	1
TGCTGCTGATGACGATGATGATGATGCTGATGATGATGATGATGATGACGCTGACTATGATGA	1
TGCTGTTGATGATGATGATGATGATGATGCTGATGATGATGATGATGATGACGATGACGATGATGA	1
TGGTGTTGATGATGATGATGATGATGATGATGATGATGATGATGACGATGACGATGATGA	1
TGATGTTGATGATGATGATGATGATGATGATGATGATGATGATGATGACGATGACGATGAGGA	2
GGATGTTGATGATGATGATGATGATGATGATGATGATGATGACGATGACGATGATGA	1
TGATGTTGATGATGATGATGATGATGATGATGATGATGATGATGATGACGATGACGAGGATGA	1
TGATGTTGATGATGATGATGATGATGATGATGATGATGATGATGATGACGTTGACGATGATGA	1
TGATGTTGAGGATGATGATGATGATGATGATGATGATGATGATGAGGACGATGACGATGATGA	1
TGAGGTTGATGATGATGATGATGATGATGATAATGATGATGATGATGATGATGACGATCACGATGATGA	1
TGATGTTGATGATGATGATGATGATGATGATGATGATGACGATGACGATGATGA	2
TGATGTTGTTGATGATGATGATGATGATGATGATGATGATGATGATGACGATGACGATGATGA	1
TGATGTTGATGATGATGATGATGATGATGATGCTGATGATGATGATGACGATGACGATGATGA	1
TGATGTTGATGAGGATGATGATGATGATGATGATGATGATGATGATGACGATGACGATGATGA	1
TGATGTTGATGATGATGAGGATGATGATGATGATGATGATGATGATGACGATGACGATGATGA	1
TGTTGTTGATGATGATGATGATGATGATGATGATGATGATGATGATGACGATGACGATGAAGA	1
TGATGTTGATGATGATGATGATGATGATGATGATGATGATGACGATGACGATGATGC	2
TGATGTTGCTGATGATGATGATGATGATGATGATGATGATGATGATGACGATGACGATGATGA	2
TGATGTTGATGATGATGATGATGATGATGATGATGATGACGATGACGATGACGATGATGA	1
TGATGTTGATGATGATGATGATGATGATGATGATGATAATGACGATGACGATGATGA	1
TGATGTTGCTGATGATGATGATGCTGATGATGATGATGATGCTGATGACGATGACGATGATGA	1
TGATGTTGATGATGTTGATGATGATGATGATGATGATGATGATGATGACGATGACGATGATGA	1
TGATGTTGATGATGATGATGATGATGATGATGATGATGATTATAATGACGATGACGATGATGA	1
TGATGTTGATGATGATGCTGATGATGATGATGATGATGATGATGATGACGATGACGATGACGATGATGA	2
TGATGTTGATGATGATGCTGATGATGATGATGATGATGATGATGATGACGATGACGATGATGA	1
TGATGTTGATGATGATTATGATGATGATGATGATGATGATGATGATGACGATGACGATGATGA	1
TGATGTTGATGATGATGATGATGATGATGATGATGATGATGATGATGACGAGGACGATGATGA	2
TGCTGTTGATGATGATGATGATGATGATGATGATGATGACGATGACGATGATGA	1
TGATGTTGATGATGATGAGGATGATGATGATGATGATGATGATGATGATGACGATGACGATGATGA	1
TGATGTTGATGATGATGATGATGAGGATGGTGATGATGATGATGATGATGATGACAGTGACGATGATGA	1
TGATGATGATGATGATGATGATGATGATGATGATGATGACGATGACGATGATGA	1
TGATTTTGATGATGATGATGATGCTGATGATGATGATGATGATGACGATGACGATGGTGA	1
GGATGTTGATGATGATGATGATGATGATGAGGATGATGATGATGATGACGATGACGATGATGA	1
TGATGTTGATGATGATGATGATGATGATGATGATGATGATGACGATGACGATGATGG	1
TGATGTTGATGATGATGATGATGATGATGCTGATGATGATGATGATGACGATGACGATGATGA	1
TGATGCTGATGATGATGATGATGATGATGATGATGATGATGATGATGACGATGACGATGATGA	1
TGATGTTGATGATGATTATGATGATGATGTTGATGATGATGATGATGACGATGACGATGATGA	1
GGATGTTGATGATGATGATGATGATGATGATGATGATGATGATGATGACGATGACGATGATGA	2
TGATGTGGATGATGATGATGATGATGATGATGATGATGATGACGATGACGATGATGA	1
TGATGTTGATGATGATGATGATGATGATGATGACGATGATGATGATGACGATGACGATGATGA	1
TGATGTTGATGATGATGATGAGGATGATGATGATGATGATGACAATGACGATGACGATGATGA	1
TGAGGTTGATGATGATGATGATGATGAGGATGATGATGATGATGATGACGATGACGATGATGA	1
TGCTGCAGATGGTGATGATGATGATGGTGTTGTTGATGATGATGATGACGATGACGCTGATGA	1
TGCTGTTGATGATGATGATGATGATGATGATGATGATGATGATGACGATGACGATGATGA	1
TGATGTTGATGATGATGATGATGATGATGATGATGATGATGACGATGACGATGACGATGATGA	2
TGATGTTGATGATGATGATGCTGATGATGATGATGATGATGATGACGATGACGATGATGA	1
TGATGTTGATGATGATGAGGATGATGATGAGGATGATGATGATGATGACGATGACGAGGATGA	1
TGAGGTGGATGATGATGATGATGATGATGAGGATGATGATGACGATGACGATGATGA	1
TGATGTTGATGATGATGATGATGATGATGAGGATGATGATGATGATGACGATGACGATGATGA	1
TGATGTTGATGATGATGATGATGATGATGGTGATGATGATGATGATGACGATGACGATGATGA	1
TGGTGTGGATGATGATGATGATGAAGATGATGAAGATGATGATGATGACGATGGCGGTGTGTA	1
TGATGTTGATGAGGATGATGATGGTGATGATGATGATGATGGCGATGACGATGATGA	1
TGATGGTGATGATGATGATGATGATGATGATGATGATGATGATGATGACGATGACGATGATGA	1
TGATGTTGATGATGATGATGATGATGATGATGATGATGAAGATGAGGACGATGACGATGATGA	1
TGATGTGGATGATGATTATGAAGATGGTGATGGTGGTGATGATGTAGACGATGACGATGATGA	1
TGATGTTGATGATGATAATGATGATGATGATGATGATGATGATGATGACGATGACGATGATGA	1
TGATGTTGATGATGATGATGATGATGATGATGATGATGATGATGATGGCGATGACGATGATGA	1
TGATGTTGATGATGATGATGATGATGATGATGATGATGATGATGATGATGATGACGATGACGATGATGA	1
TGATGTTGATGTTGATGATGATGATGATGATGATGATGATGACGATGACGATGATGA	1
TGGTGTTGATGATGATGATGATGATGATGATGATGATGATGATGATGACGAGTACGATGATGA	1
TGATGTTGATGATAATGATGATGATGATGATGATGATGATGATGATGACGATGACGATGATGA	1
TGGTGTTGGTGATGATGATGATGATGATGATGATGATGATGAGGATGACGATGACGATGCTGA	1
TGATGGTGATGATGCTGATGATGATGATGATGATGATGATGATGATGACGATGGCGATGATGC	1
TGATGTTGATGATGATGATGATGATGATGATGATGATGATGATGATGACGATGACGGTGATGA	2
GGATGTGGATGATGATGATGATGATGATGATGATGAGGATGATGATGACGATGACGATGATGA	1
TGATGTTGATGATGATGATGAGGATGATGATGATGATGATGACGATGACGATGATGA	1
TGATGCTGATGATGATGATGATGATGATGATGATGATGATGACGATGACGATGTTGA	1
TGATGATGATGAGGATGATGATGATGATGATGATGATGATGATGATGACGATGACGATGATGA	1
TGATGTTGATGATGATGATGATGATAGTGATGATGATGATGTTGCTGCCGATTCCAATGATGA	1
TGATGTTGATGTTGATGATGATGATGATGATGATGATGATGATGATGACGATGACGATGATGA	1
TGTTGTTGATGATGATGATGATGATGATGATGATGGTGATGATGATGCCGATTACGATGATGG	1
TGATGTTGATGATGATGATGATGATGATGATGATGATGATGATGATGACGATGAAGATGATGA	1
TGATGTTGATGATGATGATGATGATGATGATGGTGATGATGATGATGACGATGACGATGATGA	1
TGATGTTGATGATGATGATGATGTTGATGATGATGATGATGATGATGATGACGATGACGATGATGA	1
TGATGTTGGTGATGATGATGATGATGATGATGAGGATGATGATGATGACGATGACGATGATGA	1

Length variants:
69	8
63	196
60	24
57	37
66	13
54	4

