Subpop report generated 12-07-25 04:41:20

fastq:	/mnt/scratch45/sbiam21/all_crypto/bloomine/BlooMine_RUNDIR/SRR10363535_44298/Cp_gp60_IId/SRR10363535_44298.Cp_gp60_IId_BMfiltered.fq
flanks_fasta flanks:	/mnt/scratch45/sbiam21/all_crypto/bloomine/BlooMine_RUNDIR/tmp.Cp_gp60_IId_flanks.fa


Sequence variants:
TCGATGTTGATGATGATGATGATGACGATGATGATGATGATGATGATGATGATGATGATGATGATGA	187
TCGATGTTGATGATGATGATGATGACGATGACGATGATGATGATGATGATGATGATGATGATGATGA	1
TCGATGTTGATGATGATGATGATGACGATGATGATGATGATGATGATGATGATGATGATGATGA	10
TCGATGTTGATGATGATGATGATGACGATGATGATGTTGATGATGATGATGATGATGATGATGA	1
TCGATGATGATGATGATGATGATGACGATGATGATGATGATGATGATGATGATGATGATGATGATGA	1
TCGATGTTGATGATGATGATGATGACGATGATGATGATGATGATGATGATGATGATGATGA	3
TCGATGTTGATGATGATGATGATGACGATGATGATGATGATGATGATGATGATGATGATGACGATGA	1
TCGATGTTGATGATGATGATGATGATGA	1
TCGATGTTGATGATGATGATGATGATGATGATGATGATGATGATGATGATGATGATGATGATGAAGA	1
TCGATGTTGGTGATGATGATGATGACGATGATGATGATGATGATGATGATGATGATGATGATGATGA	1
TCGATGTTGATGATGATGATGATGACGATGATGATGATGATGATGATGATGATGATGATGATGATGATGA	1
TCGATGTTGATGATGATGATGATGACGATCATGATGATGATGATGATGATGATGATGATGATGATGA	1
TCGATGTTGATGATGATGATGAAGACGATGATGATGATGATGATGATGATGATGATGATGATGATGA	1
TCGATGTTGATGATGATGATGATGACGATGATGATGTTGATGATGATGATGATGATGATGATGATGA	1
TCGATGTTGATGATGATGATGATGACGATGATGATGATGATGATGATGATGATGATGAGGATGATGA	1
TCGATGTTGATGATGATGATGATGACGATGATGATGATGATGATGATGATGATGATGATGATGATGC	1
TCGATGTTGATGATGATGATGATGACGATGAGTGTGATGATGATGATGATGATGATGATGATGGTGG	1
TCGATGTAGATGATGATGATGATGACGATGATGAGGATGATGATGATGATGATGATGATGATGA	1
TCGTGGTTGATGATGAAGATGCTGACTATGATGATGATGACGATGATGATGATGATGATGATGATGA	1
TCGAGGTTGATGATGATGATGATGACGATGATGATGATGAAGATGATGATGATGATGAGGAGGATGA	1
TCGATGTTGATGATGATGATGATGACGATAACGATGATGATGATGATGATGATGATGAGGATGATGA	1
TCGATGTTGATGATGATGATGATGACGATGATGATGATGATGATGATGATGATGATGATGATGCTGA	1
TTGATGTTGATGATGATGATGATGACGATGATGATGATGATGATGATGATGATGATGATGATGATGA	1
TCGATGTTGATGATGATGAGGATGACGATGATGATGATGATGATGATGATGATGATGATGATGATGA	1
ACGATGTTGATGATGATGATGATGACGATGATGATGATGATGATGATGATGATGATGATAATAATGA	1
TCGATGTTGATGATGATGATGATGACGATGATGATGATGATGATGATGAGGATGATGATGATGATGA	1
TCGATGTTGATGATGATGATGATGACGATGATGATGATGATGATGATGGTGATGATGATGATGA	1
TCGATATTGATGATGATGATGATGACGATGATGATGATGATGATGATGATGATGATGATGATGATGA	1
TCGATGTTGATGTTGATGAAGATGACGATGATGCTGACAACAATGATGATGATGATGATGATGATAA	1

Length variants:
67	208
64	13
61	3
28	1
70	1

