Subpop report generated 01-08-25 05:36:55

fastq:	/home/arthur/BioInf/Crypto_work/fastq/BM_paper_missing/BlooMine_RUNDIR/SRR15694539_45022/Cp_gp60_IId/SRR15694539_45022.Cp_gp60_IId_BMfiltered.fq
flanks_fasta flanks:	/home/arthur/BioInf/Crypto_work/fastq/BM_paper_missing/BlooMine_RUNDIR/tmp.Cp_gp60_IId_flanks.fa


Sequence variants:
TCGATGTTGATGATGATGATGATGACGATGATGATGATGATGATGATGATGATGATGATGATGATGA	135
TCGATGTTGATGATGATGATGATGACGATGATGATGATGATGATGATGATGATGATGATGATGA	13
TCGATGTTGATGAGGATGATGATGACGATGATGATGATGAAGATGATGATTATGATGATGGTGA	1
TCGATGTTGATGATGATGATGACGATGATGATGATGATGATGATGATGATGATGATGATGATGA	1
TCGAAGTTGATGATGATGATGATGACGATGATGATGATGATGATGATGATGATGATGATGATGATGA	1
TCGATGTTGATGATGATGATGATGACGATGATGATGATGATGATGATGATGATGATGATGA	1
TCGATGTTGATGTTGATGATGATGACGATGATGATGATGATGATGATGATGATGATGATGATGATGA	1
TCTATGTTGATGATGATGATGACGACGATGATGATGATGATGATGATGATGATGACGATGATGATGA	1
TCGATGTTGATGATGATGATGATGACGATGATGATGATGATGATGATGATGATGATGATGATGATGATGA	1
TCGATGTAGATGATGATGATGATGACGATGATGATGATGATGATGATGATGATGATGATGATGATGA	1
TCGATGTTGATGATGATGATGACGACGATGATGACGATGATGATGCTGATGATGATGATGATGATGA	1
TCGATGTTGATGATGATGATGATGACGATGACGATGATGATGATGATGATGATGATGATGATGATGA	1
TCGATGTTGATGAAGATGATGATGACGATAATGATGATGATGATGATGATGATGATGATGAGGATGA	1
TCGATGTTGATGATGATGATGATGACTATGATGATGATGATGATGATGATGATGATGATGATGATGA	1
TCGATGTTGATGATGATGATGATGACGATGATGATGATGATGATGATGATGATGATGATGATCATGA	1
TCGCTGTTGCTGATGATGATGATGACGAGGATGATGATGATGATGATGATGATGATGATGGTGATGA	1
TCGATGTTGCTGATGATGATGATGACGAGCATGATGATGATGATGATGATGCTGATGATGATGATGA	1
TCGATGTTGATGATGATGATGATGACGATGATGATGATGATGATGATGATGATGATGACGATGATGA	1
TCGATGTTGATGATGATGATGATGACGATGATTATGATGATGATGATGATGATGATGTTGATGATGA	1
TCGGTGTTGATGATGATGATGATGACGATGATGATGATGATGATGATGATGATGATGATTATGATGA	1
TCGATGTTGATGATGATGATGATGACGGTGATGATGATGATGATGATGATGATGATGATGATGATGA	1
TCGATGTTGATGATGATGATGATGACGATGATGATGATGATGATGATGATGATGATGA	1
TCGCTGTTGATGATGATGATGTTGTCTATGATGATGATGATGATGATGATGATGATGATGATGATGA	1
TCGATGTTGATGATGATGATGATGACGATGATGATGATGATGATGATGATGATGATGATGAGGATGA	1
TCGATGTTGTTGATGATGATGATGACGATGATGATGCTGATGATGATGATGATGATGATGATGA	1

Length variants:
67	152
64	16
61	1
70	1
58	1

