Subpop report generated 11-07-25 17:48:41

fastq:	/mnt/scratch45/sbiam21/all_crypto/bloomine/BlooMine_RUNDIR/SRR10363518_43286/Cp_gp60_IIa/SRR10363518_43286.Cp_gp60_IIa_BMfiltered.fq
flanks_fasta flanks:	/mnt/scratch45/sbiam21/all_crypto/bloomine/BlooMine_RUNDIR/tmp.Cp_gp60_IIa_flanks.fa


Sequence variants:
TGATGTTGATGATGATGATGATGATGATGATGATGATGACGATGACGATGACGATGATGA	14
TGATGTTGATGATGATGATGATGATGATGATGATGATGATGACGATGACGATGACGATGATGA	216
TGATGTTGATGATGATGATGATGATGATTATGATGATGATGACGATGACGATGACGATGATGA	1
TGATGTTGATGATGATGATGGTGATGGTGATGATGATGATGACGATGAGGATGACGATGATGA	1
AGATGTTGATGATGATGATGATGATGATGATGATGATGATGACGATGACGATGACGATGATGA	1
TGATGTTGATGATGATGATGATGATGATGATAATGATGAAGACGATGACGCTGACGATGATGA	1
TGATGTTGATGATGTTGATGATGATGATGATGATGATGATGACGATGACGATGACGATGATGA	2
TGATGTTGATGATGATGATGATGATGATGATGATGACGATGACGATGACGATGATGA	2
TGATGTTGATGATGATGATGATGATGACGATGATGATGATGACGATGACGATGACGATGATGA	1
TGATGTTGTTGATGATGATGATGATGATGATGATGATGATGATGATGACGATGACGATGACGATGATGA	1
TGATGTTGATGATGATGATGATGATGGTGAGGATGAGGATGACGATGACGATGACGATGATGA	1
TGTTGTTGATGACGATGATGATGATGATGATGATGATGACGATGACGATGACGATGATGA	1
TGATGTTGATGATGATGATGAGGATGATGATGATGATGATGACGATGACGATGACGATGATGA	1
TGATGTTGATGATGATGATGATGATGATGATGATGTTGATGACGATGACGATGACGATGATGA	1
TGATGTTGATGATGATGATGATGGTGATGATGATGATGATGACGATGACGATGACGATGATGA	1
TGATGTTGATGATGATGATGATGCTGATGATGATGATGATGACGATGACGATGACGATGATCA	1
TGATGTTGATGATGATGATGGTGATGATGATGATGATGATGACGATGACGATGACGATGATGA	2
TGATGTTGATGATGATGATGATGATGATGATGATGATGATGACGATGACGAGGACGATGATGA	1
TGATGTTGATGATGATGATGATGAGGATGATGATGATGATGACGAGGACGATGACGATGATGA	1
TGATGTTGATGATGATGATGATGAAGATGTTGCTGATGATGACGATGACGATGATGATGATGA	1
TGATGTTGATGGTGATGATGATGATGATGATGATGATGATGACGATGACGATGACGATGATGA	1
TGATGTTGATGATGATGATGATGATGATGATGAAGATGATGACGATGACGATGACGATGATGA	1
TGATGATGATGATGATGATGATGCTGATGGTGATGATGATGACGATGACGATGACGACGATGA	1
TGATGTTGATGATGATGATGATGATGATGATGTTGATGATGACGATGACGATGTCGATGATGA	1
TGATTTTGATGTTGATGATGATGTTGATGATGATGATGTTGATGATGACGATGACGATGATGA	1
TGATGTCGATGATGATGTTGATGTTGATGATGATGATGATGACGATGACGATGACGATGATGA	1
TGAAGTTGATGATGATGATGATGATGATGATGATGATGATGACGATGACGATGACGATGATGA	1
TGATGTTGATGTTGATGATCATGATGATGATGACGATGACGATGACGATGACGATGATGT	1
TGATGGTGATGATGATGATGATGATGATGATGATGATGATGACGATGACGATGACGATGATGA	1
TGATGTTGATGATGATGATGATGTTGATGATGATGATGATGACGATGACGATGACGATGATGA	1

Length variants:
60	16
63	242
57	2
69	1

