Subpop report generated 12-07-25 09:38:34

fastq:	/mnt/scratch45/sbiam21/all_crypto/bloomine/BlooMine_RUNDIR/SRR10363561_43007/Cp_gp60_IIa/SRR10363561_43007.Cp_gp60_IIa_BMfiltered.fq
flanks_fasta flanks:	/mnt/scratch45/sbiam21/all_crypto/bloomine/BlooMine_RUNDIR/tmp.Cp_gp60_IIa_flanks.fa


Sequence variants:
TGATGTTGATGATGATGATGATGATGATGATGATGATGATGACGATGACGATGATGA	263
TGATGTTGATGATGACGATGATGATGATGATGATGATGATGACGATGACGATGATGA	1
TGATGTTGATGATGATGATGATGATGATGATGATGATGATGAAGATGACGATGATGA	1
TGATGTTGATGATGATGATGATGATGATGATGATGATGACGATGACGATGATGA	9
TGATGTTGATGATGATGATGTTGATGATGATGATGATGATGACGATGACGATGATGA	1
TGATGTTGTTGATGATGATGATGATGATGATGATGATGATGACGATGACGACGATGA	1
TGATGTTGCTGATGATGATGATGATGATGATGATGATGATGACGATGACGATGATGA	1
TGATGTTGATGATGATGATGATGATGATGATGATGACGATGACGATGATGA	2
TGATGTTGATGAGGATGATGATGATGATGATGATGATGATGACGATGACGATGATGA	1
TGATGTTGCTGATGATGATGATGATGATGATGATGATGTTGACGATGACGATGATGA	1
TGATGTTGATCATGATGATGATGATGATGATGATGATGATGACGATGACGATGATGA	1
TGATGTTGATGACGATGATGATGATGATGATGATGATGATGACGATGACGATGATGA	1
TGATGTTGATGATGATGATGATGATGATGATGATGATGATGTCGATGACGATGATGA	1
TGTTGTTGATGATGATGATGATGATGATGATGATGATGATGACGATGACGACGATGA	1
TGATGTTGATGATGATCATGATGATGATGATGATGATGATGACGATGACGATGATGA	1
TGATGTTGATGATGATGACGATGATGATGATGATGATGATGACGATGACGATGATGA	1
TGATGTTGATGATGATGATGATGATGATGATGACGATGACGATGATGA	1
TGATGTTGATGATGACGATGATGATGATGATGATGATGATGACGACGACGTTGATGT	1
TGATGTTGATGATGATGATGATGATGATGATGATGAAGATGACGATGACGATGATGG	1
TGATGTTGATGATGCTGATGATGATGATGATGATGATGATGACGATGACGATGATGA	1
TGATGTTGATGATGATGATGATGATGATGATGATGATGATGATGACGATGACGATGATGA	1
TGATGTTGTTGATGATGATGATGATGATGATGATGATGATGACGATGACGATGATGA	1
TGATGTTGATGCTGATGATGATGATGATGATGATGATGATGACGATGACGATGATGA	1
TGATGTTGATGATGATGATGATGATGATGATGATTATGAAGACTATGACGATGATGA	1
TGATGTTGATGGTGATGATGATGATGATGATGATGATGATGATGATGACGATGACGATGACGATGATGA	1
TGATGTTGATGATGATGATGCTGATGATGATGATGATGATGACGATGACGATGATGA	1
TGATGTTGATGATGATGATGAGGATGATGATGATGATGATGCCGATGACGATGATGA	1
TGATGTTGATGATGATGATGATGATGATGACGATGATGATGACGATGACGATGATGA	1

Length variants:
57	285
54	9
51	2
48	1
60	1
69	1

