Subpop report generated 09-07-25 20:43:39

fastq:	/mnt/scratch45/sbiam21/all_crypto/bloomine/BlooMine_RUNDIR/SRR10363300_43465/Cp_gp60_IIa/SRR10363300_43465.Cp_gp60_IIa_BMfiltered.fq
flanks_fasta flanks:	/mnt/scratch45/sbiam21/all_crypto/bloomine/BlooMine_RUNDIR/tmp.Cp_gp60_IIa_flanks.fa


Sequence variants:
TGATGTTGATGTTGATGATGATGATGATGATGATGATGATGATGATGACGATGACGATGATGA	168
TGATGTTGATGTTGATGATGATGATGATGATGATGATGATGATGACGATGACGATGATGA	7
TGATGTTGATGATGATGATGATGATGATGATGATGATGATGACGATGACGATGACGATGATGA	1
TGATGTTGATGTTGATGATGATGATCATGATGATGATGATGATGATGACGATGACGATGATGA	1
TGATGTTGATGTTGATGAAGATGATGATGATGATGATGATGATGACGATGACGATGATGA	1
TGATGTTGATGTTGATGATGATGATGATGATGATGATGATGATGATGACGGTGACGATGATGA	1
TGATGTTGATGTTGATGATGATGATGATGATGATGATGATGATGATGACGATGTCGATGATGA	1
TGAGGTTGTTGTTGATGATGATGATGATGATGATGATGATGTTGTTGACGATGACGAGGATG	1
TGATGTTGATGTTGTTGATGATGATGATGATGATGATGATGATGATGACGATGACGATGATGA	1
TGATGTTGATGTTGATGATGATGATGATGATGATGATGATGATGATGACGATGACGATGCTGA	1
TGATGTTGATGTTGATGATGATGATGATGATGATGATGATGACGATGACGATGATGA	2
TGATGGTGATGTTGATGATGATGATGATGATGATGATGATGATGATGACGATGACGATGATGA	1
TGATGTTGATGTTGATGATGATGATGATGATGATGATGATGATGATGAGGATGACGATGATGA	2
TGATGTTGATGTTGATGATGATGATGATGGTGATGATGATGATGATGACGATGACGATGATGA	1
TGAGGTGGATGTGGATGATGATGATGATGATGATGATGATGATGATGTCGATGACGATGATGA	1
TGATGTTGTTGTTGATGATGATGATGTTGATGATGATGATGTTGATGACGATTATTATGATGA	1
TGATGTTGATGTTGATGACGATGATGATGAGGATGGTGATGATGATGACGATGACGATGATGA	1
TGATGTTGATGTTGATGATGATGATAATGATGATGATGATGATGATGACGATGACGATGATAA	1
TGATGTTGATGTTGATGATGATGTTGATGATGATGATGATGATGATGACGATGACGATGATGA	1
TGATGTTGATGTTCATGATGATGATGATGATGATGATGATGATGATGACGATGAAGATGATGA	1

Length variants:
63	184
60	8
62	1
57	2

