Subpop report generated 10-07-25 13:10:50

fastq:	/mnt/scratch45/sbiam21/all_crypto/bloomine/BlooMine_RUNDIR/SRR10363365_47026/Cp_gp60_IIa/SRR10363365_47026.Cp_gp60_IIa_BMfiltered.fq
flanks_fasta flanks:	/mnt/scratch45/sbiam21/all_crypto/bloomine/BlooMine_RUNDIR/tmp.Cp_gp60_IIa_flanks.fa


Sequence variants:
TGATGTTGATGTTGATGATGATGATGATGATGATGATGATGATGATGACGATGACGATGATGA	242
TGATGTTGATGTTGATGATGTTGATGATGATGATGATGATGATGATGACGATGACGATGATGA	3
TGATGTTGATGTTGATGATGATGATGATGATGATGATGATGATGATGATGACGATGACGATGATGA	3
TGATGTTGATGTTGATGATGATGATGATGATGATGATGATGATGACGATGACGATGATGA	18
TGATTTTGATGTTGATGATGATGATGATGATGATGATGATGATGATGACGATGGCGATGATAA	1
TGATGTTGATGTTGATGATGATGATGATGATGATGATGATGATGATGATGATGACGATGATGA	1
TGATGTTGATGTTGATGATGATGGTGATGATGATGATGATGATGATGACGATGACGATGATGA	2
TGATGTTGATGTTGATGATGCTGATGATGATGATGATGATGATGATGACGATGACGATGATGA	1
TGATGGTGATGTTGATGATGATGATGATGATGATGATGATGATGATGACGATGACGATGATGA	1
TGATGTTGATGTTGATGATGATGATGATGATGATGATGATGACGATGACGATGACGATGATGA	2
TGATGTTGATGTTGATGATGATGATGATGATGATGATGGTGATGATGGCGATGACGATGATGA	1
TGATGTTGATGTTGATGATGATGATGAAGATGATGATGATGATGATGACGATGACGATGATGA	1
TGATGTTGATGTTGATGTTGATGATGATGATGATGATGATGATGATGACGATGACGATGATGA	2
TGATGTTGATGTTGATGATGATGATGATGATGATGATGATGATGGTGACGATGACGATGATGA	1
TGATGTTGATGCTGATGCTGATGATGATGATGATGATGATGATGATGACGATGACGATGATGA	1
TGATGTTGATGTTGATGATGATGATGATGATGATGATGATGATGATGACGATGACGATGATGT	1
TGATGTTGATGTTGATGATGATGATGATGATGATGATGATGATGACGATGACGATGAGGA	1
TGATGTTGATGATGATGATGATGATGATGATGATGATGATGATGATGACGATGACGATGATGA	1
TGATGTTGATGTTGATGATTATGATGATGATGATGATGATGATGATGACGATGTCGATGAGGA	1
TGATGTTGATGGTGATGATGATGATGATGATGATGATGATGATGATGACGATGACGATGATGA	1
TGTTGTTGACGCTGCTGATGCTGCTGATGATGATGATGATGATGATGACGATGACGATGATGA	1
TGATGTTGATGTTGATGATGATGATGATGATGATGATGATGATGATGACGATTACGATGATGA	1
TGATGTTGATGTTGATGATGATGATGATGGTGATGATGATGATGATGGCGATGACGATGATGA	1
TGATGTTGATGTTGATGATGATGATGATGATGATGATGATGATGATGACGATAACGATGATGA	1
TGATGTTGATGTTGATGATGATGATGATGATGATGATGATGATGATGACGATGACGATGANGA	1
TGATGTTGATGTTGATGATGATGATGAAGATGATGATGATGATGATGACGATGACGATGANGA	1
TGATGTTGATGTTGATGATNATGATGATGATGATGATGATGATGATGACGATGACGATGATGA	1
TGATGTTGATGTTGATGATGATGATGATGATGATGATGATGATGATGACGTTGACGATGATGA	1
TGATGTTGATGTTGATNATGATGATGATGATGATGATGATGATGATGACGATGACGATGATGA	1
TGATGTTGATGTTGATGATGATGATGATGCTGATGATGATGATGATTACGATGACGATGATGA	1
TGATGTTGATGTTGATGATGATGATGATGATGTTGATGATGATGATGACGATGACGATGATGA	1
TGATGTTGATGTTGATGGNGATGCTGATGATGATGATGATGTTGATGACGATGACGATGATGA	1
TGATGTTGATGTTGATGATGATGATGATGATGATGNTGATGATGACGATGACGATGATGA	1
TGATGTTGATGTTNATGATGATGATGATGATGATGATGATGATGATGACGATGACGATGATGA	2
TGATGTTGATGTTGATGATGATGATGATGATGATGATGATGATGAGGTCGATGACGATGATGA	1
AGATGTTGATGTTGATGATGATGATGATGATGATAATGATGACGAGGACGAGGACGAGGATGA	1
TGATGTTGATGTTGATGATGATGATGATGATGATGATGATGGTGATGACGATGAGGATGATGA	1
TGATGTTGATGTTGATGAGGATGATGATGATGATGATGATGATGATGACGATGACGATGATGA	1
TGATGTTNATGTTGATGATGATGATNATGATGATGATGATGATGATGACGATGACGATGATGA	1
TGANGGTGATGTTGATGATGATGATGATGATGATGATGATGATGATGACGATGACGATGATGA	1
TGANGTTGATGTTGATGATGATGATGATGATGATGATGATGATGATGACGATGACGATGATGA	1
TGCTGTTGATGTTGATGAAGATGATGATGATGTTGATGATGATGATGACGGNTAAGATGAGGA	1
TGATGTTGATGTTGATGATGATGATGATGACGATGATGATGATGATGACGATGACGATGATGA	1
TGTTGTTGATGTTGATGATGATGATCATGATGATGATGATGATGATGACGATGACGATGATGA	1
TGATGTTGATGTTGATGATGATGATGATGATGATGATGATGATGCTGATGTTGACGATGATGA	1
TGATGTTCATGTTGATGATGATGATGATGATGATGATGATGATGATGACGATGACGATGATGA	1
TGATGTTGATGTTGATGATGATGTTGATGATGGTGATGATGATGATGACGATGACGATGTTGA	1
TGATGTTGATGTTGATGATGATGATGATGATGATGATGATGATGATGACGATGATGATGATGA	1
TGATGTTGATGNTGATGATGATGATGATGATGATGATGATGATGATGACGATGACGATGATGA	1

Length variants:
63	292
66	3
60	20

