Subpop report generated 10-07-25 03:38:55

fastq:	/mnt/scratch45/sbiam21/all_crypto/bloomine/BlooMine_RUNDIR/SRR10363338_43450/Cp_gp60_IIa/SRR10363338_43450.Cp_gp60_IIa_BMfiltered.fq
flanks_fasta flanks:	/mnt/scratch45/sbiam21/all_crypto/bloomine/BlooMine_RUNDIR/tmp.Cp_gp60_IIa_flanks.fa


Sequence variants:
TGATGTTGATGAGGATGATGATGATGATGATGATGATGATGATGACGATGACGATGATGA	1
TGATGTTGATGATGATGATGATGATGATGATGATGATGATGACGATGACGATGATGA	135
TGATGTTGATGATGATGATGATGATGATGATGATGATGACGATGACGATGATGA	10
TGATGTTGCTGCTGATGATGATGATGATGATGATGATGATGACGTTGACGATGATGA	1
TGATGTTGATGATGCTGATGACGATGATGATGATGATGATGACGATGACGATGATGA	1
TGATGTTGATGATGATGATGATGATGATGATGATGATGATGATGACGATGACGATGATGA	1
TGATGTTGATGATGATGATGATGATGATGATGATGATGATGTCGATGACGATTATGA	1
TGATGTTGATGATGATGATGATGATGATGATGATGATGACTACGATGACGATGATGA	1
TGATGTTGATGATGATGATGATGAAGATGATGATGATGATGACGATGAAGATGATGA	1
TGATGTTGATGATGATGATGACGATGATGATGATGATGAAGACGATGACGATGATGA	1
TGATGTTGATGATGATGATGATGATGATGATGATGATGATGATGATGATGATGATGA	1
TGATGTTGATGATGATGATGAGGATGATGATGATGATGATGACGATGACGATGATGA	1
TGATGTTGATGATGATTATGATGATGATGATGATGATGATGACGATGACGATGATGA	1
TGATGTTGATGATGATGATGATGATGATGATGATGATGATGTCGATGACGATGATGA	1
TGAGGTTGATGATGATGATGATGATGATGATGATGATGATGACGATGACGATGATGA	1
TGATGTTGATGATGATGATGACGATGATGATGATGATGATGACGATGACGATGATGA	1
TGATGTTGATTATGATGATGATGATTATGATGATGATGATGACGATGACGATGATGA	1
GGATGTTGATGATGATGATGATGATGATGATGATGATGACGATGACGATGATGA	1

Length variants:
60	2
57	148
54	11

