Subpop report generated 01-08-25 09:38:51

fastq:	/home/arthur/BioInf/Crypto_work/fastq/BM_paper_missing/BlooMine_RUNDIR/SRR15694523_42986/Cp_gp60_IId/SRR15694523_42986.Cp_gp60_IId_BMfiltered.fq
flanks_fasta flanks:	/home/arthur/BioInf/Crypto_work/fastq/BM_paper_missing/BlooMine_RUNDIR/tmp.Cp_gp60_IId_flanks.fa


Sequence variants:
TCGATGTTGATGATGATGATGATGACGATGATGATGATGATGATGATGATGATGATGATGATGATGA	109
ACGATGTTGATGATGATGATGATGACGATGATGATGATGATGATGATGATGATGTTGATAGTGATGA	1
TCGATGTTGATGATGATGATGATGACGATGATGAAGATGATGATGATGATGATGATGATGATGA	1
TCGATGTTGATGATGATGATGATGACGATGATGATGATGATGATGATGATGATGATGATGATGATGATGA	1
TCGATGTTGATGATGATGATGATGACGATGCTGATGATGATGATGATGATGATGATGATGATGATGA	1
TCGATGTTGATGATGATGATGATGACGATGATGATGATGATGATGATGATGATGATGATGATGA	6
TCGATGTTGATGATGATGATGATGACGATGAGGAGGATGAGGATGTTGATGATGATGATGATGA	1
TCGATGTTGATGATGATGATGATGACGATGATGATGATGATGATGATGATGATGATGATTATGATGA	1
TCGATGTTGATGATGATGATGATGACGATGATGATGATGATGATGATGATGATGATGATGA	1
TCGATGTTGATGATGATGATGATGACGATGATGATGATGATGATGATGATGATGATGATGATGATGC	1
ACGATGCTGATGATGATGATGATGACGATGATGATGATGATGATGATGATGATGATAATGATGATGA	1
TCGATGTTGATGATGATGATAATGACGATGATGATGATGATGATGATGATGATGATGATGATGA	1
TCGATGTTAATGATGATGATGATGACGATGATGATGAGGATGATGATGATGATGATGATGA	1
TCGATGTTGATGATGATGATGATGCCGATGATGATGATGATAATGATGATGATGATGATGTTGATGA	1
TCGATGTTGATGATGATAATGATGACGATGATGATGATGATGATGATGATGATGATGATGATGA	1

Length variants:
67	115
64	10
70	1
61	2

