Subpop report generated 12-07-25 13:04:48

fastq:	/mnt/scratch45/sbiam21/all_crypto/bloomine/BlooMine_RUNDIR/SRR10363569_42982/Cp_gp60_IId/SRR10363569_42982.Cp_gp60_IId_BMfiltered.fq
flanks_fasta flanks:	/mnt/scratch45/sbiam21/all_crypto/bloomine/BlooMine_RUNDIR/tmp.Cp_gp60_IId_flanks.fa


Sequence variants:
TCGATGTTGATGATGATGATGATGACGATGATGATGATGATGATGATGATGATGATGATGATGATGA	88
TCGATGTTGATGATGATGATGGTGACGATGATGATGATGATGATGAGGATGATGATGATGATGATGA	1
TCGATGTTGATGATGATGATGATGACGATGATGATGATGATGATGATGATGATGATGATGATGA	7
TCGATGTTGTTGATGATGATGATGACGATGATGATGATGATGATGATGATGATGATGATGATGATGA	1
TCGATGTTGATGATGATGATGATGACGATGATGATGATGATGATGATGATGATGATGATGATGATGATGA	2
TCGATGTTGATGATGATGATGATGACGATGATGATGATGATGATGATGATGTTGATGATGATGATGA	1
TCGAAGTTGATGATGATGATGATGACGATGATGATGATGATGATGATGATGATGATGATGATGATGA	1
TCGATGTTGATGATGATGATGATGACGATGATGATGATGATGATGATGATGATGATGATGTTGATGA	1
TCGATGTTGATGATGATGATGATGACGATGATGATGATGATGATGATGATGATGGTGGTGATGATGA	1
TCGATGTTGATGATGATGATGACGATGATGATGATGATGATGATGATGATGATGATGATGATGA	2
TCGATGTTGATGATGATGATGATGACGATGATGATGATGATGATGATGATGATGTTGATGGTGATGA	1
TCGATGTTGATGATGATGATGATGACGAGGATGATGATGATGATGATGATGATGATGATGATGATGA	1
TCGATGGTTATGATAATGATGATGACGATGATGATGATGATGATGATGATGATGATGATGATGATGA	1
TCGACGATTATGATGATGAGGATGAAGATGATGATTATGATGATGATGATGATGATGTTGATGATGA	1
TCGATGTTGATGATGATGATTATTACGATGAGGATGATGATGCTGATGATGATGATGATGATGATGA	1
TCGATGTTGATGATGTTGATGATGACGATGATGATGATGATGATGATGATGATGATGATGATGATGA	1
TCGATGTTGATGATGATGATGTTGACGATGATGATGTTGATGATGATGATGATGACGATGATGATGA	1

Length variants:
67	101
64	9
70	2

