Subpop report generated 01-08-25 13:53:01

fastq:	/home/arthur/BioInf/Crypto_work/fastq/BM_paper_missing/BlooMine_RUNDIR/SRR15694567_24696/Cp_gp60_IId/SRR15694567_24696.Cp_gp60_IId_BMfiltered.fq
flanks_fasta flanks:	/home/arthur/BioInf/Crypto_work/fastq/BM_paper_missing/BlooMine_RUNDIR/tmp.Cp_gp60_IId_flanks.fa


Sequence variants:
TCGATGTTGATGATGATGATGATGACGATGATGATGATGATGATGATGATGATGATGATGAGGATGATGA	1
TCGAGGTTGATGATGATGATGATGACGATGATGATGATGATGATGATGATGATGATGATGATGATGATGA	1
TCGATGTTGATGATGATGATGATGACGATGATGATGATGATGATGATGATGATGATGATGATGATGATGA	79
TCGTTGTTGATGATGATGATGATGACGATGATGATGATGATGATGATGATGATGATGATGATGATGATGA	1
TCGATGTTGATGATGATGATGATGACGATGATGATGATGATGATGACGATGATGATGATGATGATGATGA	1
TCGATGTTGATGAAGATGATGATGACGATGATGATGATGATGATGATGATGATTAATATGAAGATGAAGA	1
TCGATGTTGATGATGATGATGATGACGATGATGATGATGATGATGATGATGATGATGATGATGAGGATGA	2
TCGATGTTGATGATGATGATGATGACGATGATGATGATGATGATGATGAGGATGATGATGATGAGGATGA	1
TCGATGTTGATGATGATGATGATGACGATGATGATGATGATGATGATGAGGATGAGGATGATGATGCTGA	1
TCGATGTTGATGATGATGATGATGACGATGATGATGATGATGATGATGATGATGTTGATGATTATGATGA	1
TCGATGTTGATGATGATGATGATGACGATGATGATGATGATGATGATGATGATGATGATGATGATGCTGA	1
TCGATGTTGATGATGATGATGATGACGATGATGATGATGATGATGATGATGAGGATGATGATGATGATGA	2
TCGATGTTGATGATGATGATGATGACGATGATGATGATGATGATGCTGATGATGATGATGATGATGACGA	1
TCGATGTTGTTGATGATGATGATGCCGATGATGATGATGATGATGATGATGATGATGAGGATGATGAGGA	1
TCGATGTTGATGATGATGATGATGACGATGATGATGATGATGATGATGATGCTGATGAGGCTGCTGCTGA	1
TCGATGTTGATGATGATGATGATTACGATGATTATGATGATGATGATGATTATTATTATGATGATGATGA	1
TCGAGGTTGATGATGATGATGATGACGATGATGATGATGATGATGATGATGATGATGATGATGATGAAGA	1
TCGATGTTGAAGATGATGATGTTGACGATGATGATGATGTTTATGATGATGATGATGATGATTAATATGA	1
TCGTTGTTGATTATGATTATGTTGTAGATGCTGTTGATGATGATGATGCTGATGATTATGATGATGAGGA	1
TCGATGTTGATGATGATGATGATGACGATGATGATGATGATGATGATGATGATGCTGATGATGATGATGA	1
TCGATGTTGATGATGATGATGATGACGATGATGATTATGATGATGATGATGATGATGATGATGATGATGA	2
TCGATGTTGATGATGATGATGATGACGATGATGATGATGATGATGATGATGATGCTGATGATGATGA	1
TCGATGTTGATGATGATGATGATGACGATGAGGATGATGATGATGATGATGATGATGATGATGATGATGA	1
TCGATGTTGATGATGATGATGATGACGATGATGATGATGATGATGATGATGATGATGATGCTGCTGATGA	1
TCGATGTTGATGATGATGATGATGACGATGATGATGATGATGATGATGATGATGATGCTGAGGATGATGA	1
TCGATGTTGGTGATGATGATGATGACGATGATGATGATGATGATGATGATGATGGTGATTATTATGATGA	1
TCGATGTTGATGATGATGATGATGACGATGATGATGATGTTGTTGATGATGATGATGATGATGTTGATTA	1
TCGATGTTGATGATGATGATGATGACGATGATGATGATGATGATGATGATGATGATGATGCTGATGATGA	1
TCGATGTTGATGATGATGATGATGACGATGATGATGATGATGATGATGATGATGATGATGATGATGA	2
TAGATGTTGATGATGATGATGATGACGATGATGATGATGATGATGATGATGATGATGATGATGAAGATGA	1
TCGATGTTGATGATGATGATGATGACGATGATGATGATGATGATGATGATGATGATGATGATGACGA	1
TCGAGGTTGATGATTATGATTAAGACGATGATGATTATGATGATGATTATGATTATTATGATTATTATGA	1
TCGATGTTGATGATGATGATGATGACGATGATGATGATGATGATGATGATGATGATGATGATGCTGATGA	1
TCGATGTTGATGATGATGATGATGACGATGCTGATGATGATGATGATGATGATGATGATGATGATGATGA	1
TCGATGTTGATGATGTTGATGATGTCGATGATGATGATGATGCTGATGATGATGATGATTATGATGATGA	1
TAGATGTTGATGATGATGATGATGACGATGATGATGATGATGATGATGATGATGATGATGATGATGA	1
TCGATGTTGATGATGATGATGATGACGATTATGATGATGATGATGATGATGATGATGATGATGATGATGA	1
TCGATGTTGATGATGATGATGATGACGATGATGATGATGATGATGATGATGCTGACGAAGATGAGGATGA	1
TAGTTGTTGATGATGATGATGATGAAGATGATGATGATGCTGATGATGATGATGATGATGATGATGATGA	1
TCGATGTTGATGATGATGATGATGACGATGATGATGATGATGATGATGATGATGATGAGGATGATGATGA	1
TCGATGTTGATGATGATGATGATGACGATGATGATGATGATGATGATGATGATGATGATGATGAAGA	1
TCGATGTTGATGATGATGATGTTGACGATGATGATGATGATGATGATGATGATGATGATGATGATGATTA	1
TCGATGTTGATGATGATGATGATGACGATGATGATGATGATGATGATGATGATGATGATGATGATGATGG	1
TCGTTGTTGATGATGATGATGATGACGATGATGATGATGATGATGATGATGCTGATGCTGATGAGGATGA	1
TCGATGTTGATGATGATGATGATGACGATGATGATGATGATGACGATGATGATGAGGATGAGGCTGATGA	1
TCGATGTTGATGATGATGATGATGACGATGATGATGATGATGATGATGATGATGATGATTATGATGATGA	1
TCGATGTTGATGATGATGATGATGACGATGATGATGATGATGATGAGGATGAGGATGATGATGATGATGA	1
TCGATGTTGATGATGATGATGATGACGCTGATGATGATGATGATGATGATGATGATGATGATGATGATGA	1
TCGATGTTGATGATGATGATGATGACGATGATGATGATGATGATGATGATGCTGAGGATGATGCTGATGA	1
TCGATGTTGATGATGATGATGATGACGATGATGATGATGATGATGATGATGATGATGATGATGACGATGA	1
TCGATGTTGATGATGATGATGATGAAGATGATGATGATGATGATGATGATGATGATGATGATGATGATGA	1
TCGATGTTGATGATGATGAAGATGACGATGATGCTGATGATGATGATGATGATGATGATGATGATGCTGA	1
TCGATGTTGATGATGATTATGATGACGATGATGATGATGATGATGATGATGATGATGATTATGATGATGA	1
TCGATGTTGATGATTATGATGATGACGATGATGATGATGATGATGATGATGATGATGATGATGATGATGA	1
TCGATGTTGATGATGATGATGATGACGATGATGATGATGATGATGATGATGATGATGATGATGATGAAGA	1
TCGATGTTGATGATGATGAGGATGACGATGATGATGATGTTGATGATGATGATGATGATGATGATGATGA	1
TCGATGTTGATGATGATGATGATGACGATGATGATGATGATGATGATGATGATGATTATGATGATTATGA	1

Length variants:
70	133
67	6

