Subpop report generated 12-07-25 06:48:49

fastq:	/mnt/scratch45/sbiam21/all_crypto/bloomine/BlooMine_RUNDIR/SRR10363554_44191/Cp_gp60_IIa/SRR10363554_44191.Cp_gp60_IIa_BMfiltered.fq
flanks_fasta flanks:	/mnt/scratch45/sbiam21/all_crypto/bloomine/BlooMine_RUNDIR/tmp.Cp_gp60_IIa_flanks.fa


Sequence variants:
TGATGTTGATGTTGATGATGATGATGATGATGATGATGATGATGATGACGATGACGATGACGATGATGA	260
TGATGTTGATGTTGATGATGATGATGATGATGATGATGATGATGATGACGATGATGATGACGATGATGA	1
TGATGTTGATGTTGATGATGATGATGATGATGATGATGATGATGACGATGACGATGACGATGATGA	11
TGATGTTGATGCTGATGATGATGATGATGATGATGATGATGATGATGACGATGACGATGACGATGATGA	1
TGATGTTGATGTTGAAGATGATGATGATGATGATGATGATGATGATGACGATGACGATGACGATGATGA	1
TGATGTTGATGTTGATGATGATGATTATGATGATGATGATGATGATGACGATGACGATGACGATGATGA	1
TGATGTTGATGTTGATGATGATGATGATGATGATGATGATGATGATGACGATGACTATGACGATGATGA	1
TGATGTTGATGTTGATGATGATGATGATGATGATGATGATTATGATGACGATGACGATGACGATGATGA	2
TGATGTTGATGTTGATGATGATGATGATGATGATGATGATGATTATGACGATGACGATGACGATGATGA	1
TGATGTTGATGTTGATGATGATGATGATGATGATGATGATGATGATGACGATGACGATGACGATGATGG	1
TGATGTTGATGTTGATGATGATGATGATGATGATGAGGATGATGATGACGATGACGATGACGATGATGA	1
TGATGTTGATGTTGATGATGACGATGATGATGATGATGATGATGATGACGATGACGATGACGATGATGA	1
TGATGTTGATGTTGATGATGATGATGATGATTATGATGATGATGATGACGATGACGATGACGATGATGA	1
TGATGTTGATGTTGATGATGATGATGATGATGATGATGATGATGANGACGATGACGATGACGATGATGA	1
TGATGTTGATGTTGCTGATGATGATGATGATGATGATGATGATGATGACGATGACGATGACGATGATGA	1
TGATGTTGATGTTGATGATGATGATGATGTTGATGATGATGATGATGACGATGACGATGACGATGATGA	1
TGATGTTGATGTCGATGATGATGATGATGATGATGATGATGATGACGATGACGATGACGATGATGA	1
TGATGTTGAGGTTGATGATGATGATGATGATGATGATGATGATGATGACGATGACGATGACGATGATGG	1
TGATGTTGATGTTGATGATGATGATGATGATGATGATGATGATGATGATGACGATGACGATGACGATGATGA	2
TGATGTTGATGTTGATGATGATGATGATGATGATGATGATGATAATGACGATGACGATGACGATGATGA	1
TGATGTTGATGTTGATGATGATGATGATGATGATGATGATGATGATGACAATGACGATGACGATGATGA	1
TGATGTTGATGTTGATGATGACGATGATGATGATGATGATGATGACGATGACGATGACGATGATGA	1
TGATGTTGATGTTGATGATGATGATGATGATGATGATGATGATGATGATGATGACGATGACGATGATGA	1
TGATGTTGATGATGTTGATGATGATGATGATGATGATGATGAAGATGACGATGACGATGACGATGATGA	1
TGATGTTGATGTTGATGATGATGATGATGATGATGATGATGATGATGACGATGACGATGACGACGATGA	1
TGATGTTGATGTTGATGATGATGATGATGACGATGATGATGATGATGACGATGACGATGACGATGATGA	1
TGATGTTGATGTCGATGATGATGATGATGATGATGATGATGATGATGACGATGACGATGACGATGATGA	1
TGATGTAGATGTTGATGATGATGATGATGATGATGATGATGATGATGACGATGACGATGACGATGATGA	1
TGATGTTGATGTTGATGATGATGATGATGATGATGATGATGATGATGACGATGAAGGAGACGATGATGA	1
TGATGTTGATGTTGATGATGATGATGATGATGATGATGATGATGATGACGATGACGAAGACGATGATGA	1
TGATGTTGATGTTGATGATGATGATGATGATGATGATGATGATGATGACGATGACGATGACGATGATGC	1
TGATGTTGATGTTGATGATGATGATGATGATGATTATGATGATGATGACGATGACGATGACGATGATGA	1
TGATGTTGATGTTGACGATGATGATGATGATGATGATGATGATGATGACGATGACGATGACGATGATGA	1
TGATGTTGATGTTGATGATGATGATGATGATGATGATGATGATGACGATGACGATGACGATGATCA	1
TGATGTTGTAGTTGATGATGATGATGATGATGAAGAAGATGATGAAGACGATGACGATGACGATGATGA	1
TGATGTTGATGTTTATGATGATGATGATGATGATGATGATGATGATGACGATGACGATGACGATGATGA	1
GGATGTTGATGTTGATGATGATGATGATGATGATGATGATGATGATGACGATGACGATGACGATGATGA	2

Length variants:
69	293
66	14
72	2

