Subpop report generated 09-07-25 22:18:59

fastq:	/mnt/scratch45/sbiam21/all_crypto/bloomine/BlooMine_RUNDIR/SRR10363303_43461/Cp_gp60_IIa/SRR10363303_43461.Cp_gp60_IIa_BMfiltered.fq
flanks_fasta flanks:	/mnt/scratch45/sbiam21/all_crypto/bloomine/BlooMine_RUNDIR/tmp.Cp_gp60_IIa_flanks.fa


Sequence variants:
TGATGTTGATGATGATGATGATGATGATGATGATGATGATGACGATGACGATGATGA	186
TGATGTTGATGATGATGATGATGATGATGATGATGATGACGATGACGATGATGA	13
TGATGTTGATGATGATGAGGATGATGATGATGATAATAATGACGATGACGATGATTA	1
TGATGTTGATGATGATGATGATGATGATGATGATGACGATGACGATGATGA	1
TGATGTTGATGATGATGATGATGATGAGGATGATGATGATGACGATGACGATGATGA	1
TGATGTTGATGATGATGATGATGATGATGATGATGATGATGACGATGACTATGATGA	1
TGATGTTGATGATGATGATGATGATGATGATGATGATGATGACGAAGACGATGATGA	1
TGATGTTGATGATGATGATGATGATGATGATGATGACGATGACGATGACGATGATGA	1
TGATGTTGATGATGATGATGATGATGATGATGATGTTGATGACGATGACGATGATGA	1
TGATGTTGATGTTGATGATGATGATGATGATGATGATGATGACGATGACGATGATGA	1
TGATGTTGATGATGATGATGATGATGATGATGATGATGATGACGATGGCGATGATGA	1
TGATGTTGATGATTATGATGTTGCTGTTGATGATGATGATGACGATGTCGATGATGA	1
TGATGTTGCTGATGATGATGATGATGCTGTTGATGATGATGACGATGACGATGATGA	1
TGATGTTGATGATGATGAGGCTGCTGATGATGATGATGATGACGATGACGATGATGA	1
TGATGTTGATGCTGATGATGATGATGATGATGATGATGATGACGATGACGATGATGA	1
TGATGTTGATGATGATGATGATGATGATGAGGATGATGATGACGATGACGATGATGA	1
GGATGTTGATGATGATGATGATGATGATGATGATGATGATGACGATGACGATGATGA	1
TGATGTTGATGATGATGATGATGATGATGATGATGAGGATGACGATGACGATGATGA	1
TGATGTTGATGATGATGACGATGATGATGATGATGATGACGATGACGATGATGA	1
TGATGTTGATGATGATGATGATGATGATGATGATGATGATGACGAGGACGATGATGA	1
TGATGTTGATGATGAGGATGATGATGATGATGATGATGATGACGATGACGATGATGA	1

Length variants:
57	203
54	14
51	1

