Subpop report generated 01-08-25 12:12:43

fastq:	/home/arthur/BioInf/Crypto_work/fastq/BM_paper_missing/BlooMine_RUNDIR/SRR15694484_22973/Cp_gp60_IId/SRR15694484_22973.Cp_gp60_IId_BMfiltered.fq
flanks_fasta flanks:	/home/arthur/BioInf/Crypto_work/fastq/BM_paper_missing/BlooMine_RUNDIR/tmp.Cp_gp60_IId_flanks.fa


Sequence variants:
TCGAGGTTGATGATGATGATGATGACGATGATGATGATGATGATGATGATGATGATGATGATGATGA	1
TCGATGTTGATGATGATGATGATGACGATGATGATGATGATGATGATGATGATGATGATGATGATGA	42
TCGATGTTGATGATGATGATGATGACGATGAGGATGATGATGATGATGATGATGATGCTGCTGAGGA	1
TCGATGTTGATGATGATGATGATGACGATGATGATGATGATGATGATGATGATTATGATGATGATGA	1
TCGATGTTGATGATGATGATGATGACGATTATGATGTTGTTGATGATGATGATGATGATGATGCTGA	1
TCGATGTTGATGATGATGATGAAGACGATGAAGATGATGATGATGATGAAGATGATGATGATGA	1
TCGATGTTGATGATGATGATGATGACGATGATGATGATGATGATGATGATGATGATGATGATGA	2
TCGATGTTGATGATGATGATGAGGACGATGATGATGATGATGATGATGATGATGATGATGATGATGA	1
TCGAGGTTTATGATGATGATGATGACGATGATGATGATGATGATTATGATGATGATGATGATGATGA	1
TCGATGTTGATGATGATGATGATGACGATGATGATGATTATGATTATGATGATGATGATGATGATGA	1
TCGATGTTGATGATGATGATGATGACGATGATGATGATGATGATGATGATGATGATGATGA	2
TCGATGTTGATGATGATGATGATGACGATGATGATTATGATGATGATGATGATGATGATGATGATGA	1
TCGATGTTGATGATGATGATGACGACGATGATGATGATGATGATGATGATGATGATGATGATGATGA	1
TCGATGTGTATGATGATGATGATGACGATGATGATGATGATGATGATGATGATGAAGATGATGATGA	1
TCGATGTTGATGATGATGATGATGACGATGATGATGATGATGATGATGATGATGAGGATGATGATGA	2
TCGATGTTGATGATGATGATGATGACGATGATGATGATGATGATGATGATTATGATGATGATGATGA	1
TCGATGGTGATGATGATGATGATGACGATGATGATGATGATGATGATGATGATTATGATGATGATGA	1
TCGATGTTGATGATGATGATGATGACGATGATGATGATGATGATGATGATGATGATGATGATGATGATGA	1
TCGATGTTGATGATGATGATGCTGACGATGATGATGATGATGATGATGATGATGATGAGGCTGATGA	1
TCGATGTTGATGATGATGATGATGACGATGATGATGATGATGATGATGATGATGATGATGAGGATGA	3
TCGATGTTGATGATGATGATGATGACGATGATGATGATGATGATGATNATGATGATGATCATGATGA	1
TCGATGTTGATGATGATGATGATGACGATGATGATGTTGATGATGATGATGATGATGATGATGATGA	1
TCGATGTTGATGATGATGATGATGACGATGATGATGATGATGATGATGATGATGAGGATGAGGATGA	1
TAGATGTTGATGATGATGATGATGACGATGATGATGATGAAGATGATGATGAAGATGAAGATGATGT	1
TAGATGTTGATGATGATGATGATGACGATGATGATGATGATGATGATGATGATGATGATGATGATGA	2
TCGATGTTGATGATGATGATGATGACGATGATGATGATGATGATGATGATGATGATGATGATGATGC	1
TCGATGTTGATGATGAAGATGATGACGATGATGATGATGATGATGAAGATGATGATGATGATGATGA	1
TCGATGTTGATGATGATGATGATGACGATGATGATGATGAAGATGATGATGATGATGATGATGATGA	1
TCGATGTTGATGTTGATGATGATGACGATGATGATGATGATGATGATGATGATGATGAGGATGATGA	1

Length variants:
67	70
64	3
61	2
70	1

