Subpop report generated 01-08-25 13:18:58

fastq:	/home/arthur/BioInf/Crypto_work/fastq/BM_paper_missing/BlooMine_RUNDIR/SRR15694565_24721/Cp_gp60_IId/SRR15694565_24721.Cp_gp60_IId_BMfiltered.fq
flanks_fasta flanks:	/home/arthur/BioInf/Crypto_work/fastq/BM_paper_missing/BlooMine_RUNDIR/tmp.Cp_gp60_IId_flanks.fa


Sequence variants:
TCGATGTTGATGATGATGATGATGACGATGATGATGATGATGATGATGATGATGATGAGGAGGATGCTGA	1
TCGATGTTGATGATGATGATGATGACGATGATGATGATGATGATGATGATGATGATGATGATGATGATGA	32
TCGAGGTTGATGATGATGATGATGACGATGATGATGATGATGATGATGATGATGATGATGATGATGATGA	1
TCGATGTTGATGATGATGATGATGACGATTATGATGATGATGATGATGATGATGATTATGATGATGATGA	1
TCGATGTTGATGATGATGATGATGACGATGATGATGATGATGATGATGATGATGATGATGATGATGAGGA	1
TCGTTGTTGATGATGATGATGATGACGCTGATGATGATGATGATGCGGATGATGATGATGATGATGATGC	1
TCGATGTTGATGATGATGATGATGCCGATGATGATGATGATGATGAAGATGAAGATGATGATGATGATGA	1
TCGATGTTGATGATGATGATGATGACGATGATGATGATGATGATGATGATGATGATGATGATGATGA	5
TCGATGTTGATGATGATGATGATGAAGATGATGATGATGATGATGATGATGATGATGATGATGATGATGA	1
TCGATGTTGATGATGATGATGATGAAGATGATGATGATGATGATGATGAGGATGAGGATGCTGATGATGA	1
TCGATGTTGATGATGATGATGATGACGATGATGATGATGATGCTGATGCTGATGATGCTGAGGATGATGA	1
TCGATGTTGATGATGATGATGATGACGATGATGATGATGATGATGATGATGATGATGATGATGAGGATGA	1
TAGTTGTTGATGATGATGATGATGACGATGATGATGATGATGATGATGATGATGATGATGATGATGATGA	1
TCGATGTTGATGATGATGATGATGACGATGATGATGATTATGATGATGCTGATGATGATGATGATGATGA	1
TCGATGTTGATGATGATGATGATGACGATGATGATGATGATGAGGATGATGATGAGGATGATGACGAGGA	1
TCGATGTTGATGATGATGATGATGACGATGATGATGATGCTGATGATGATGATGATGCTGCTGATGATGA	1
TCGATGTTGTTGATGATGTTGATGACGATGATGATGATGATGATGATGATGATGATGATGATGATGATGA	1
TCGATGTTGATGATGATGATGTTGACGATGATGATGATGATGATGATGATGATGATGATGATGATTATTA	1
TAGATGTTGATGATGATGATGATGACGATGATGATGATGATGATGATGATGATGATGATGATGATGATGA	1
TCGATGTTGATGATGATGATGATGACGATGATGATGATGATGATGATGATGATGATGAGGATGATGATGA	2
TCGATGTTGATGATTATGATGATGACGATGATGATGATTATGATGATGATGATGATGATGATGATGAAGA	1
TCGATGTTGATGATGATGATGATGACGATGATGATGATGATGATGATGCTGATGATGATGATGATGATGA	1
TCGATGTTGATGATGATGATGATGACGTTGTTGATGATGTTGATGATGATGTTGTGGATGATTTTGTTGT	1
TGGATGTTGATGATGATGATGATGACGATGATGATGATGATGATGATGATGATGATGATGATGATGATGA	1
TCGATGTTGATGATGATGATGATGACGATGATGTTGATGATGATGATGATTATGATGATGATGATGATGA	1
TCGATGTTGATGATGATGATGATGACGATGATGATGATGATGATGATGATGATGATGATGATGATTATGA	1

Length variants:
70	57
67	5

