Subpop report generated 12-07-25 14:33:11

fastq:	/mnt/scratch45/sbiam21/all_crypto/bloomine/BlooMine_RUNDIR/SRR10363573_42973/Cp_gp60_IId/SRR10363573_42973.Cp_gp60_IId_BMfiltered.fq
flanks_fasta flanks:	/mnt/scratch45/sbiam21/all_crypto/bloomine/BlooMine_RUNDIR/tmp.Cp_gp60_IId_flanks.fa


Sequence variants:
TCGATGTTGATGATGATGATGATGACGATGATGATGATGATGATGATGATGATGATGATGATGATGA	92
TCGNTNTTGATGATGATGATGATGACGATGATGATGATGATGATGATGATGATGATGATGATGATGA	1
TCGATGTTGATGATGATGATGATGACGATGATGATGATGATGATGATGATGATGATGATGATGA	9
TCGATGTTGATGATGATGATGATGACGATGATGATGATGATGATGATGATGATGATGATGATGATGATGA	5
TCGATGTTGATGATGATGATGCTGACGATGATGATGATGATGATGATGATGATGATGATGATGATGA	1
TCGATGTTGATGATGATAATGATGACGATGATGATGATGATGATGATGATGATGATGATGATGATGA	1
TCGATGCTGATGATGATGATGATGACGATGGTGATGATGATGATGATGATGATGATGATGATGATGATGA	1
TCGATGTTGATGATGAAGATGATGACGATGATGATGATGATGATGATGATGATGATGATGATGATGA	1
TCGATGTTGATGATGATGATGATTACGATGATGATGATGATGATGATGATGATGATGATGATGATGA	1
TCGATGTTGATGATGATGATGATGACGATGATGATGATGATGATGATGATGATGA	1
TCGATGTTGAGGATGATGATGATGACGATGATGATGATGATGATGATGATGATGATGATGAGGATGA	1
TCGATGTTGATGATGATGATGATGACGATGATGAAGATGATGATGATGATGATGATGATGATGATGA	1
TCGATGTTGATGATGATGATGATGACGACGATGATGATGATGATGATGATGATGATGATGATGATGA	1
TCGATGTTTATAATTATGATGATGACGATGAAGATGATGATGATGATGATGTTGATGATGA	1
TCGATGTTGATGATGATGATGATGACGATGATGATGATGATGATGATGATGATGATGATGATGATGT	1
TCGATGTTGATGATGATGATGATGACGAGGATGATGATGATGATGATGATGATGATGATGATGA	1
TCGATGTTGATGATGATGATGATGACGTTGATGATGATGATGATGATTATGAGAATGATGATGATGA	1
TCGATGATGATGATGATGATGATGACGATTATGATGATGATGATGATGATGATGATGATGATGATGA	1
TCGATGTTGATGATGATGATGATGACGATGATGATGATGATGCTGATGATGATGATGATGATGATGA	1
TCGATGCTGATGATGATGATGATGACGACGGCGATGATGACGATGATGATGATGATGATGATGATGA	1
TCGATGTTGATGATGATGATGATGACGATGATGATGATGATGATGATGATGATGATGATTATGATGA	1
TCGTTGTTGTTGATGATGATGAGGACGAGGGTGATGATGGTGATGATGATGATGATGATGATGATGA	1

Length variants:
67	107
64	10
70	6
55	1
61	1

