Subpop report generated 01-08-25 09:16:47

fastq:	/home/arthur/BioInf/Crypto_work/fastq/BM_paper_missing/BlooMine_RUNDIR/SRR15694572_45012/Cp_gp60_IId/SRR15694572_45012.Cp_gp60_IId_BMfiltered.fq
flanks_fasta flanks:	/home/arthur/BioInf/Crypto_work/fastq/BM_paper_missing/BlooMine_RUNDIR/tmp.Cp_gp60_IId_flanks.fa


Sequence variants:
TCGATGTTGATGATGATGATGATGACGATGATGATGATGATGATGATGATGATGATGATGATGATGA	114
TGGATGTAGATGATGATGAGGATGACGATGAGGATGATGATGATGAGGATGATGATGATGATGATGA	1
TCGATGTTGATGATGATGATGATGACGATGATGATGATGATGATGATGATGATGATGATGATGA	7
TCGATGTTGATGATGATGACGATGACGATGATGATGATGATGATGATGATGATGATGATGATGATGA	1
TCGATGTTGATGATGATGATGATGACGATGATGATGATGATGATGATGATGATGATGCTGATGA	1
TCGATGTTGATGATGATGATGATGACGATGATGATGATGATGATGATGATGATGATGATGGTGATGA	1
TCGATGTTGATGATGATGATGATGAGGATGATGATGATGATGATGATGATGATGATGATGATGAAGA	1
TCGCTGTTGATGATGATGATGATGACGATGATGGTGGTGATGATGATGATGATGATGATGATGATGA	1
TCGATGTTGATGATGATGATGATGACGATGATGATGATGATGATGATGATGATGATGATGATGATGATGA	1
TCGATGGTGATGATGATGATGATGACGATGATGATGATGATGATGATGATGATGATGATGATGATGA	1
TCGATGTTGATGATGATGATGATGACGCTGATGATGATGATGATGATGATGATGATGATGATGATGA	1
TCGATGTTGATGATGATGATGATGACGATGATGATGATGATGATGATGATGATGATGAGGATGATGA	1
TCGATTTTGATGATGATGATGATGACGATGATGATGATGTTGATGATGATGATGATGATGAAGA	1
TCGATGTTGCTGATGATGATGATGACGATGATGATGATGATGATGATGATGATGATGATGATGA	1
TCGATGTTGATGATGATGATGATGACGATGATGATGATGATGATGATGATGATGATGATGATGAAGA	1
TCGATGTTGATGATGATGATGATGACGATGATGATGATGATGTTGATGATGATGATGATGATGATGA	1
TCGATGTTGATGATGATGATGATGACTATGATGATGATGATGATGATGATGATGATTATGATGATGA	1

Length variants:
67	125
64	10
70	1

