Subpop report generated 09-07-25 22:42:59

fastq:	/mnt/scratch45/sbiam21/all_crypto/bloomine/BlooMine_RUNDIR/SRR10363304_43460/Cp_gp60_IIa/SRR10363304_43460.Cp_gp60_IIa_BMfiltered.fq
flanks_fasta flanks:	/mnt/scratch45/sbiam21/all_crypto/bloomine/BlooMine_RUNDIR/tmp.Cp_gp60_IIa_flanks.fa


Sequence variants:
TGATGTTGATGATGATGATGATGATGATGATGATGATGATGACGATGACGATGATGA	248
TGATGTTGATGATGAGGATGATGATGATGATGATGATGATGACGATGACGATGAGGA	1
TGATGTTGATGATGATGATGATGATGATGATGATGATGATGACGATGACGATGATGC	1
TGATGTTGATGATGATGATGATGAAGATGATGATGATGATGACGATGACGATGATGA	1
TGATGTTGATGATGATGATGATGATGATGATGATGACGATGACGATGATGA	3
TGATGTTGATGATGATGATGATGATGATGATGATGATGACGATGACGATGATGA	7
TGATGTTGATGATGATGATGATGATGATGATGATGATGATGATGGCGATGACGATGGTGC	1
TGATGTTGATGATGATGATGATGATAATGATGATGATGATGACGATGACGATGATGA	1
TGATGTTGATGATGATGATGATGATGATGATGATGATGATGATGATGACGATGACGATGATGA	1
TGATGTTGATGATGGTGATGATGATGATGATGTTGATGATGACGATGACGATGATGA	1
TGATGTTGATGATGATGATGATAATGATGATGATGATGATGATGATGACGATGATGA	1
TGATGTTGATGATGATGATGATGATGATGATGATGATGATGACGATGACGATGCTGA	1
TGATGTTGATGATCATGATGATGATGATGATGATGATGATGACGATGACGATGATGA	1
TGATGTTGATGATGATGATGATGGTGATGATGATGATGATGACGATGACGATGGTGA	1
TGATGTTGTTGATGATGATGATGATGATGATGATGATGATGACGATGACGATGATGA	1
GGATGTTGATGATGGTGATGATGAAGATGCTGCTGATGATGACGATGACGATGATGA	1
TGAGGTTGATGATGATGATGATGATGATGATGATGATGATGACGATGACGATGATGA	1
TGATGTTGATGCTGATGATGATGCTGATGATGATGATGATGACGATGACGATGATGC	1
TGATGTTGATGATGAGGATGATGATGATGATGATGATGATGACGATGACGATGATGA	1
TGATGTTGATGATGATGATGATGATGATGATGATGATGATGACGATGACGATGATCA	1

Length variants:
57	263
51	3
54	7
60	1
63	1

