Subpop report generated 12-07-25 02:31:36

fastq:	/mnt/scratch45/sbiam21/all_crypto/bloomine/BlooMine_RUNDIR/SRR10363531_43024/Cp_gp60_IIa/SRR10363531_43024.Cp_gp60_IIa_BMfiltered.fq
flanks_fasta flanks:	/mnt/scratch45/sbiam21/all_crypto/bloomine/BlooMine_RUNDIR/tmp.Cp_gp60_IIa_flanks.fa


Sequence variants:
TGATGTTGATGTTGATGATGATGATGATGATGATGATGCTGATGATGACGATGACGATGACGATGATGA	1
TGATGTTGATGTTGATGATGATGATGATGATGATGATGATGATGATGACGATGACGATGACGATGATGA	310
TGATGTTGATGTTGATGATGATGATGATGATGATGATGATGATGATGACGATGACGATGGCGATGATGA	1
TGATGTTGATGTTGATGTTGATGATGATGATGATGATGATGATGATGACGATGACGATGACGATGATGA	1
TGATGTTGATGTTGATGATGATGATGATGATGATGATGATGATGACGATGACGATGACGATGATGA	16
TGAGGTTGATGTTGATGATGATGATGATGATGATGATGATGATGATGACGAGGACGATGACGATGATGA	1
TGATGTTGATGTTGATGATGATGATGATGATGATGATGATGATGATGACGATGACGATGATGA	1
TGATGTTGATGTTGATGATGATGATGATGATGATGATGATGACGATGACGATGACGATGACGATGATGA	1
TGATGTTGATGTTGATGATGATGATGATGATGATGATGATGTTGATGACGATGACGATGACGATGATGA	1
TGATGTTGATGTTGATGATGATGATGATGATGATGATGATGATGATGATGACGATGACGATGACGATGATGA	1
TGATGTTGATGTTGTTGATGATGATGATGATGATGATGATGATGATGACGATGACGATGACGATGATGA	2
TGAGGTTGAGGTTGATGATGATGATGATGATGATGATGATGATGATGACGATGACGATGACGATGATGA	1
TGATGTTGATGATGATGATGATGATGATGATGATGATGATGACGATGACGATGATGA	1
TGATGTTGATGTAGATGATGATGATGATGATGATGATGATGATGATGACGATGACGATGACGATGATGA	1
TGATGTTGATGTTGATGATGATGATGATGATGATGATGTTGATGATGACGATGACGATGACGATGATGA	1
TGATGTTGATGTGGATGATGATGATGATGATGATGATGATGATGATGACGATGACGATGACGATGATGA	1
TGATGTTGATGTTGATGATGATGATGATGATGTTGATGATGATGATGACGATGACGATGACGATGATGA	1
TGATGTTGATGTTGATGATGATGATGATGATGATAATGATGATGATGACGATGACGATGACGATGATGA	1
GGATGTTGATGTTGATGATGATGATGATGATGATGATGATGATGATGACGATGACGATGACGATGATGA	1
TGATGTTGATGTTGATGATGATTATGATGATGATGAGGATGATGATGACGATGACGATGACGATGATGA	1
TGATGTTGATGTTGATGATGTTGATGATGATGATGATGATGATGATGACGATGACGATGACGATGATGA	2
AGATGTTGATGTTGATGATGATGATGATGATGATGATGATGATGATGACGATGACGATGACGATGATGA	1
TGAGGTTGATGTTGATGATGATGATGATGATGATGATGATGATGATGACGATGACGATGACGATGATGA	1
TGATGTTGATGTTGATGATGATGATGATGATGGTGATGATGATGATGACGATGACGATGACGATGATGA	1
TGATGTTGATGTTGATGAGGATGATGATGATGATGATGATGATGATGACGATGACGATGACGATGATGA	3
TGATGTTGATGTTGATGGTGATGATGATGATGATGATGATGATGATGACGATGACGATGACGATGATGA	1
TGATGTTGCTGTTGATGCTGATGATGATGATGATGAGGATGATGATGACCATGACGATGACGATGCTGA	1
TGATGTTGATGTCGATGATGATGATGATGATGGTGATGATGATGATGACGATGTCGATGACGATGATGA	1
TGATGTTGATGTTGATGATGATGATGATGGTGATGATGATGATGATGACGATGACGATGACGATAATGA	1
TTATGTTGATGATGTAGATGATGATGATGATGAAGATGATTATGAAGATGCTGATGAAGAAGATGA	1
TGATGTTGGTGTTGATGATGATGATGATAATGATGATGATGATGATGACGATGACGATGACGATGATGA	1
TGACGTTGATGTTGATGATGATGATGATGATGATGATGATGATGATGACGATGACGATGACGATGATGA	1
TGATGTTGAGGTTGATGATGATGATGATGATGATGGTGATGATGATGACGATGAGGGTGACGATGATGA	1
TGATGTTGATCTTGATGATGATAATGATGATGATGATGATGATGATGACGCTGACGATCACGATGATGA	1
TGATGTTGATGTTGATGATGATGATGATGATGATGACGATGACGATGACGATGATGA	1
TGATGATGATGTTGATGATGATGATGATGATGATGATGATGATGATGACGATGACGATGACGATGATGA	1
TGATGTTGATGTTGATGATGATGATGATGATGATGATTATGATGATGACGATGACGATGACGATGATGT	1
TGTTGTTGAGGTTGATGATGAGGATGATGACGATGATGATGATGATGACGATGACGATGACGATGATGA	1
TGATGTTGATGTTGATGATGATGATGATGCTGATGATGATGATGATGACGATGACGATGACGATGATGA	1
TGATGGGGAGGGTGATGATGATGATGGTGACGATGGTGATGATGATGACGAGGACGATGACGATGATGA	1
TGATGTTGATGTTGATGATGATGATAATGATGATGATGATGATGATGACGATGACGATGACGATGATGA	1
TGATGTTGATGTTGATGATGATGATGATGAAGATGATGAGGATGATGACGATGACGATGACGATGGTGA	1
TGATGTTGATGTTGATGATGATTATGATGATGATGATGATGATGAAGACGATGACGATGACGATGATGA	1

Length variants:
69	350
66	17
63	1
72	1
57	2

