Subpop report generated 10-07-25 12:44:46

fastq:	/mnt/scratch45/sbiam21/all_crypto/bloomine/BlooMine_RUNDIR/SRR10363362_47029/Cp_gp60_IIa/SRR10363362_47029.Cp_gp60_IIa_BMfiltered.fq
flanks_fasta flanks:	/mnt/scratch45/sbiam21/all_crypto/bloomine/BlooMine_RUNDIR/tmp.Cp_gp60_IIa_flanks.fa


Sequence variants:
TGATGTTGATGTTGATGATGATGATGATGATGATGATGATGATGATGACGATGACGATGATGA	217
TGATGTTGATGTTGATGATGATGATGATGATGATGATGATGATGACGATGACGATGATGA	15
TGATGTTGATGTTGATGATGATGATGATGACGATGATGATGATGATGACGATGACGATGATGA	1
TGATGTTGATGTTGATGATGATGATGATGATGATGATGAAGATGATGACGATGACGATGATGA	1
TGATGTTGATGTTGATGATGATGATGATGATGATGATGATGATGATGATGACGATGACGATGATGA	1
TGATGTTGATGTTGTTGATGATGATGATGATGATGATGATGATGATGACGATGACGATGATGA	1
TGATGTTGATGTTGATGATGATGATGATGATAATGATGATGATGATGACGATGACGATGATGA	1
TGTTGTTGGTGTTGGTGATGATGATGATGATGATGATGATGATGATGACGATGACGATGATGA	1
TGATGTTGATGTTGATGATGATGATGATGATGATGATGATGATGATGACGAAGACGATGATGA	1
TGATGTTGATGTTGATGTTGATGATGATGATGATGATGTTGATGATGACGATGACGATGATGA	1
TGATGTTGATGTTGATGATGATGATGATGATGGTGATGATGATGATGACGATGACGATGATGA	2
TGATGTTGATGTTGATGATGATGATGATGATGATGATGATGATGATGGCGATGACGATGATGA	2
TGATGTTGATGTTGATGATGATGATGATAATGATGATGATGATGATGACGATGACGATGATGA	1
TGATGTTGATGTTGATGATGATGATGATGAGGATGATGATGATGATGACGATGACGATGATGA	1
TGATGTTGATGTTGATGATGATGATGATGATGATGATGATGATGAGGACGATGACGATGATGA	1
TGATGTGGATGTTGATGATGATGATGATGATGATGATGATGATGATGACGATGACGATGATGA	1
TGATGTTGATGTTGATGATGATGCTGATGATGATGATGATGCTGATGGCGATGACGATGATGA	1
TGATGGTGATGTTGATGATGATGATGATGATGATGATGATGATGATGACGATGACGATGATGA	2
TGATGTTGATGTTGATGATGATGATGCTGATGATGATGATGATGATGACGATGACGATGATGA	1
TGATGTTGATGGTGATGATGATGATGATGATGATGATGATGATGACGATGACGATGATGA	1
TGATGTTGATGTTGATGATGATGATGATGATGATGATGATGATGATGACGATGACGATGATGG	1
TGCTGTTGATGTTGATGATGATGATGATGATGATGATGATGATGGTGAAGATGTCGATGCTGA	1
TGATGTTGATGTTGATGATGATGAGGATGATGATGATGATGATGATGACGATGACGATGATGA	1
TGCTGTTGATGTTGATGATGATGATGCTGATGATGATGATGATGATGACGATGACGATGATGA	1
TGATGTTGATGTTGATGATGATGATGATGATGATGATGNTGATGATGACGATGACGATGATGC	1
TGATGTTGATGTTGATGATGATGATGATGATNATGATGATGATGATGACGATGACGATGATGA	1
TGATGTTGATNTTGATGATGATGATGATGATGATGATGATGATGATGACGATGACGATGATGA	1
TGATGTTGATGCTGATGATGATGATGATGATGATGATGATGTTGATGACGATGACGATGATGA	1
TGATGTTGATGTTGATGATGATGATGATGATGATGATGATGNTGATGACGATGACGATGATGA	1
TGATGTTGATGTTGATGATGATGATGATGATGATGATGATGATGATGACGATNACGATGATGA	1
TGATGTTGATGTTGATGATGTTGATGATGATGATGATGATGATTATGGCGATGACGATGATGA	1
TGATGTTGATGTTGATGATGATGATGATGCTGATGATGATGATGATGACGATGACGATGATGA	1
TGATGTTGATGTTGATGTTGATGATGATGATGATGATGATGATGATGACGATGACGATGATGA	2
TGATGTTGATGTTGATGATGATGTTGATGATGTTGATGATGATGATGACGATGACGATGATGA	1
TGATGTTGATGTGGATGAGGATGATGAGGATGAGGATGATGATGATGACGATGAGGATGATGA	1
TGGTGTTGATGTTGATGATGATGATGATGATGATGATGATGATGATGACGATGACGATGATGA	1
TGATGTTGATGTTGATGATGAGGATGATGATGATGATGAAGATGATGACAATGACGATGATGA	1
TGATGTTGATGTTGATGATGATGATGATNATGATGATGATGATGATGACGATGACGATGATGA	2
TGAAGATGATGTTTATGATGATGATGATGAGGATGATGAAAATGATGACGATGACGAGGATGA	1
TGATGTTGATGATGATGATGATGATGATGATGATGATGATGATGATGACGATGACGATGATGA	1
TGATGTAGATGTTGATGATGATGATGATGATGATGATGATGATGACGATGACGATGATGA	1
TGATGTCGATGTTGATGATGATGACGATGATGATGATGATGATGATGACGATGACGATGATGA	1
TGATGTTGATGGTGATGATGATGATGATGATGATGATGATGCTGATGACGATGACGATGATGA	1
TGTTGTTGATATTGATGATGATGATGATGATGATGTTGATGATGATGACGACGACGTAGATGA	1
TGATGTTGATGTTGATGATGATGATGATGATGATGATGATGATGATGACGATGACGNTGATGA	1
TGATGTTGATGTTGATGATGATGATGATGANGATGATGATGATGACGATGACGATGATGA	1

Length variants:
63	262
60	18
66	1

