Subpop report generated 01-08-25 13:22:29

fastq:	/home/arthur/BioInf/Crypto_work/fastq/BM_paper_missing/BlooMine_RUNDIR/SRR10363586_43782/Cp_gp60_IIa/SRR10363586_43782.Cp_gp60_IIa_BMfiltered.fq
flanks_fasta flanks:	/home/arthur/BioInf/Crypto_work/fastq/BM_paper_missing/BlooMine_RUNDIR/tmp.Cp_gp60_IIa_flanks.fa


Sequence variants:
TGATGTTGATGATGATGATGATGATGATGATGATGATGATGATGATGATGATGATGATGACGATGACGATGATGA	193
TGATGTTGATGATGATGATGATGATGATGATGATGATGATGATGATGATGACGATGATGACGATGACGATGATGA	1
TGATGTTGATGATGATGATGATGATGATGATGATGATGATGATGATGATGATGATGACGATGACGATGATGA	18
TGATGTTGATGATGATGATGACGATGATGATGATGATGATGATGATGATGATGATGATGACGATGACGATGATGA	1
TGATGTTGATGATGATGATGATGATGATGATGATGATTATGATGATGATGATGATGATGACGATGACGATGATGA	1
TGATGTTGATGATGATGATGATGAGGATGATGATGATGATGATGATGATGATGATGATGACGATGACGATGATGA	1
GGATGTTGATGATGATGATGATGATGATGATGATGATGATGATGATGATGATGATGACGATGACGATGATGA	1
TGATGTTGATGATGATGATGATGATGATGATGATGATGATGATGATGATGAAGATGATGACGATGACGATGATGA	1
TGATGTTGATGATGATGATGATGATGATGATGATGATGATGATGATGATGATGATGATGACGATTACGATGATGA	1
CGATGTTGATGATGATGATGATGATGATGATGATGATGATGATGATGATGATGATGATGACGATGACGATGATGA	1
TGATGATGATGATGATGATGATGATGATGATGATGATGATGATGATGATGATGATGATGACGATGACGATGATGA	1
TGATGTTGATGTTGATGATGATGATGATGATGATGATGATGATGATGATGATGATGATGACGATGACGATGATGA	2
GGATGTTGATGATGATGATGATGATGATGATGATGATGATGATGATGATGATGATGATGACGATGACGATGATGA	1
TGATGTTGATGATGATGATGATGATGCTGATGATGATGATGATGATGATGATGATGATGACGATGACGATGATGA	1
GGATGATGATGATGATGATGATGATGATGATGATGATGATGATGATGATGATGATGATGACGATGACGATGATGA	1
TGATGTTGATGATGATGATGATGATGATGATGATGATGATGATGATGATGATGACGATGACGATGATGA	2
TGATGTTGATGATGATGAGGATGATGGTGCTGATGATGATGATGAAGATGATGATGATGACAATGACGATGATGA	1
TGATGTTGATGATGATGATGATGATGATGATGATGATGATGATGATGCTGATGATGATGACGATGACGCTGATGA	1
TGATGTTGATGATGATGATGATGATGATGATGATGATGATGATGATGATTATGATGATGACGATGACGATGATGA	1
TGATGTTGATGATGATGATGATGATGATGATGATGATGATGATGATGATGATGATGACGACGATGACGATGATGA	1
TGATGTTGATGATGATGATGATGATGAGGATGATGATGATGATGTTGATGATGATGATGCCGATGAAGATGATGA	1
TGATGTTGATGATGATGACGATGATGATGATGATGATGATGATGCTGACGATGATGATGACGATGACGATGGTGA	1
TGATGTTGATGATGATGATGATGATGATGATGCAGGTGATGATGATGATGATGATGATGACGATGACGATGATGA	1
TGATGTTGATGATGATGATGATGATGATGATGATGATGATGATGATGATGATGATGATGACGATGATGA	1
TGATGTTGATGATGATGATGATGATGATGATGATGATGATGATGATGATGATGATGATGACGATGACGATAATGA	1
TGATGTTCATGATGGTGATGAGGATGTTGATTATGATGATGATGTGGATGATGATTATGATGATGACTATGATGA	1
TGATGTTGATGATGATGGTGATGATGATGATGATGATGATGATGATGATGATGATGATGACGATGACGATGATGA	1
TGATGTTGATGATGATGATGATGATGATGATGATGATGATGATGATGATGATGATGATGATGACGATGATGA	1
TGATGTTGATGATGAGGATGATGATGATGATGATGATGATGATGATGATGATGATGATGACGATGACGATGATGA	1
TGATGTTGTTGATGATGATGATGATGATGATGATGATGATGACGATGACGATGATGA	1
TGACGTTGAAGATGATGATGATGATGATGGTGACGATGATGTCGATGATTAAGTTGATGACAATGACAATGATGA	1
TGATGTTGATGATGATGATGATGATGATGATGATCATGATGATGATGATGATGATGATGATGACGATGACGATGATGA	1
TGATGTTGATGATGATGATGATGATGATGATGATGATGATGATGATGATGATGATGATGATGACGATGACGATGATGA	2
TGATGCTGACGATGATGATGATGAGGATGATGATGGTGATGCCGCTGACGATGATGA	1
TGATGTTTATGATGATGATGATGATGATGATGATGATGATGATGATGATGATGATGATGACGATGACGATGATGA	1
TGATGTTGATGATGATGATGATGATGATGATGATGATGATGATGATGAGGATGATGATGACGATGACGATGATGA	1
TGATGTTGATGTTGATGATGATGATGATGTTGATGATGATGATGATGATGAAGATGATGACGATGACGATGATGA	1
TGATGTTGATGATGATGATGATGATGATGATGATGATGATGATGATGATGATGATGATGGCGATGACGATGCTGA	1
TGATGTTGATGATGATGATGATGATGATGATGATGATGATGATGATGACGATGACGATGATGA	1
TGATGTTGATGAAGATGATGATGAAGATGATGATGATGATGATGATGAAAATAATGATGACGATGACGATGATAA	1
TGATGTTGATGATGATGATGATGATGATGATGATGATGATGATGATGTTGATGATGATGACGATGACGATGATGA	1
TGAGGTTGATGATGATGATGATGATGATGATGATGATGATGATGATGATGATGATTATGACTATGACGATGATGA	1
CGCTGTTGATGATGGTGATGATGATGATGATGATGATGATGACGATGACGATGATGA	1
TGATGTTGATGATGATGATGATGATGATGATGATGATGATGATGATGATGATGCTGATGACGATGACGATGATGA	1

Length variants:
75	226
72	20
69	3
57	3
78	3
63	1

