Subpop report generated 01-08-25 08:35:10

fastq:	/home/arthur/BioInf/Crypto_work/fastq/BM_paper_missing/BlooMine_RUNDIR/SRR15694569_12535/Cp_gp60_IId/SRR15694569_12535.Cp_gp60_IId_BMfiltered.fq
flanks_fasta flanks:	/home/arthur/BioInf/Crypto_work/fastq/BM_paper_missing/BlooMine_RUNDIR/tmp.Cp_gp60_IId_flanks.fa


Sequence variants:
TCGATGTTGATGATGATGATGATGACGATGATGATGATGATGATGATGATGATGATGATGATTATGATGA	1
TCGATGTTGATGATGATGATGATGACGATGATGATGATGATGATGATGATGATGATGATGATGATGATGA	30
TCGATGTTGATGATGATGATGATGACGATGATGATGAGGATGATCATGATGATGATGAAGATGATGATGA	1
TCGATGTTGATGATGATGATGATGACGATGATGATGATGATGAGGATGATGATGATGATGATGAGGATGA	1
TCGATGTTGATGATGATGATGATGACGATGATGATGATGATGATGATGATGCTGATGATGATGATGATGA	1
TCGATGTTGATGATGATGATGATGACGATGATGATGATGATGATGATGATGATGATGATGATGATTATGA	1
TCGATGTTGAGGATGATGATGATGACGATGATGATGATGATGATGATGATGATGATGATGATGATGATGA	1
TCGATGTTGATGATGATGATGATGACGATGATGATGATGATGATGATGATGATGATGATGATGATGA	2
TCGATGTTGATGATGATGATGATGACGATGATGATGATGAGGATGATGATGATGATGATGATGATGATGA	1
TCGATGTTGATGATGATGATGATGACGATGATGATGATGATGATGAGGATGATGATGATGATGATGATGA	1
TCGATGTTGATGATGATGATGATGACGATGATGATGATGATGATGATGAGGATGATGATGATGATGATGA	1
TCGATGTTGATGATGATGATGATGACGATGATGATGATGATGATGATGATGATGATGATGATGATGAAGA	1
TCGATGTTGATGATGATGATGATGACGATGATGATGATGATGATGATGATGATGCTGATGATGATGATGA	2
TCGATGTTGATGATGATGATGANGACGATGATGATGATGATGATGATGATGATGATGATGATGATGATGA	1
TCGATGTTGATGTTGATTATGATGACGATGATGATGTTGATGTTGATGATGATGCGGTTGATGATGATGA	1
TCGATGTTGATGATGATGATGAGGACGATGATGATGATGAAGATGATGATGATGATGATGATGATGAGGA	1
TCGAGGTTGATGATGATGATGATGACGATGATGATGATGATGATGATGATGATGATGATGATGATGATGA	2
TCGATGTTGATGATGATGATGATGACGATGATGATGATGATGATGATGATGATGATGATGAGGATGATGA	1
TCGATGTTGATGATGATGATGATGACGATGATGATGATGATGCTGATGACGCTGCTGATGAAGATGCCGA	1
TCGATGTTGATGATGATGCTGATGCCGAGGAGGATGATGAGGATGCGGAGGCGGATGCTGATGCTGATGA	1
TCGATGTTGATGATGATGATGATGACGATGATGATGATGATGATGACGATGATGATGATGATGATGATGA	1
TCGATGTTGATGATGATGATGATGACGATGATGATGATGATGATGATGATGAGGATGATGATGATGATGA	2
TCGATGTTGATGATGATGATGATGAAGATGATGATGTTTATGATGATTATGATTATTATGATGATGATGA	1
TCGATGTTGATGATGATGATGATGACGATGATGATGATGATGATGATGATGCTGATGAGGATGATGATGA	1
TCGATGTTGATGATGATGATGATGACGATGATGATGATGATGATGATGATGATGATGATTATGATGATGA	1
TCGATGTTGATGATGATGATGATGACGATGATGATGATGATGATGAAGATGATGATGATGATGACGATGA	1
TCGATGTTGATGATGATGATGATGACGATGATGATGATGATGATGATGATGAAGATGATGATGATGATGA	1

Length variants:
70	58
67	2

