Subpop report generated 01-08-25 05:02:14

fastq:	/home/arthur/BioInf/Crypto_work/fastq/BM_paper_missing/BlooMine_RUNDIR/SRR15694561_45016/Cp_gp60_IId/SRR15694561_45016.Cp_gp60_IId_BMfiltered.fq
flanks_fasta flanks:	/home/arthur/BioInf/Crypto_work/fastq/BM_paper_missing/BlooMine_RUNDIR/tmp.Cp_gp60_IId_flanks.fa


Sequence variants:
TCGATGTTGATGATGATGATGATGACGATGATGATGATGATGATGATGATGATGCTGATGATGATGA	1
TCGATGTTGATGATGATGATGATGACGATGATGATGATGATGATGATGATGATGATGATGATGATGA	126
TTGATGATGATGATGATGATGATGACGATGATGATGATGATGATGATGATGATGATGATGATGATGA	1
TCGATGTTGATGATGATGATGATGACGATGATGATGATGATGATGATGATGATGATGATGATGA	8
TCGATGTTGATGATGATGATGATGACGATGATGATGATGATGAAGATGATGATGATGATGATGATGA	1
TCGGTGTTTATGATGATGATGATGACGATGATGATGATGATGATGATGATGATGATGATGA	1
TCGATGTTGATGATGATGATGATGACGATGATGATGATGATGATGATGATGATGATGATGATAATGA	1
TCGATGTTGATGATGATGATGATGACGATGATGATGATGATGATGATGATGATGATGATGATGATGATGA	2
TCGATGTTGATGATGATGATGATGACGATGATGATGCTGATGATGATGATGATGATGATGATGATGA	1
TCGATGTTGATGATGATGATGTTGACGATGATGATGATGATGATGATGATGATGATGATGATGATGA	1
TCGATGTTGATGATGATGATGACGACGATGATGATGATGATGATGATGATGATGATGATGATGATGA	1
TCGATGTTGATGGAGATGGTGAAGACGATGATGATGATGATGATGATGATGATGATGATGATGATGA	1
TCGAGGTTGGTGATGATGTTGATGACGATGATGATGATGATGATGATTTTGTTGATTATGATGATTA	1
TCGATGTTGATGATGATGATGATGACGATGATGATGATGATGATGATGATGATGATGATGAGGATGA	1
TCGATGTTGTTGATGATGATGATGACGATGATGATGATGATGATGATGATTATGATGATGATGATGA	1
TCGATGTTGATGATGATGATGATGACGACGATGATGATGATGATGATGATGATGATGATGATGA	1
TCGATGTTGATGATGAGGATGGTGACGATGATGATGATGATGATGATGATGATGATGATGATGATTA	1
TCGATGTTGATGATGATGATGATCACGATGATGATGATGATGATGATGATGATGATCATGATGCTGA	1
TCGATGTTGATGATGATGATGATGACGATGATGGTGATGATGATGATGATGATGATGATGATGATGA	1
TCGATGTTGATGATGATGATGATGTCGATGATGATGATGATGATGATGATGAAGATGATGATGATGA	1
TCGATGTTGATGATGATGATGATGACGATGATGATGATGATGATGTTGATGATTATGATGATGATGA	1
TCGATGTTGATGATGATGATGATGATGACGATGATGATGATGATGATGATGATGATGATGATGATGA	1
ACGATGTTGACGATGATGATGATGACGATGTTGATGATGAAGATGATGATGATGATAATGATGATGC	1
GCGATGTTGATGATGATGATGATGACGATGATGATGATGATGATGATGATGATGATGATGATGATGA	1
TCGATGTTGATGATGATGATGATGACGATGATGATGATGATGATGATGATGATGATTATGATGATGA	1
TCGATGTTGATGATGATGCTGATGACGATGACGATGATGATGATGATGATGATGATGATGATGATGA	1
TCGATGCTGATGATGATGATGATGACGATGATGATGATGATGATGATGATGATGATGATGATGA	1

Length variants:
67	147
64	10
61	1
70	2

