Subpop report generated 12-07-25 07:26:06

fastq:	/mnt/scratch45/sbiam21/all_crypto/bloomine/BlooMine_RUNDIR/SRR10363557_43790/Cp_gp60_IIa/SRR10363557_43790.Cp_gp60_IIa_BMfiltered.fq
flanks_fasta flanks:	/mnt/scratch45/sbiam21/all_crypto/bloomine/BlooMine_RUNDIR/tmp.Cp_gp60_IIa_flanks.fa


Sequence variants:
TGATGTTGATGATGATGATGATGATGATGATGATGATGATGATGATGACGATGACGATGACGATGATGA	319
TGATGTTGATGATGATGATGATGATGATGATGATGATGATGATGATGACGATGACGATGACGATTATGA	1
TGATGTTGATGATGATGATGATGATGATGATGATGATGATGATGATGACGATGACGATGACGATGAGGA	1
TGATGTTGATGATGATGATGATGATGATGATGATGATGATGATGAAGACGATGACGATGACGATGATGA	2
TGTTGTTGATGATGATGATGATGATGATGATGATGATGATGATGATGACGATGACGATGACGATGATGA	1
TGATGTTGATGATGATGATGATGATGATGATGATGATGTTGATGATGACGATGACGATGACGATGATGA	1
TGATGTTGATGATGATGATGATGATGATGATGATGATGATGATGACGATGACGATGACGATGATGA	10
TGATGTTGATGATGATGATGATGATGATGATGATGATGATGATGATGACGATGACGATGACGACGATGA	1
TGATGTTGATGATGATGATGATGATGATGATGATGATGATGACGATGACGATGACGATGATGA	2
TGAAGTTGATGATGATGATGATGATGATGATGATGATGATGATGATGACGATGACGATGACGATGATGA	1
TGATGTTGATGATGATGATGATGATGATGATGATGATGATGATGATGACGACGACGATGACGATGATGA	1
TGATGTTGATGATGATGATGATGATTATGATGATGATGATGATGATGACGATGACGATGACGATGATGA	1
TGATGTTGATGATGATGATGATGATGACGATGATGATGATGAGGATGACGATGACGATGACGATGATGA	1
TGATGTTGATGATGATGATGATGATGATGATGATGATGATGATGATGCCGATGACGATGACGATGATGA	1
TGATGTTGATGATGATGATGATGATGAGGATGATGATGATGATGATGACGATGACGATGACGATGATGA	1
TGATGTTGATGATGATGCTGATGATGATGATGATGATGATGATGATGACGATGACGATGACGATGATGA	1
TGATGTTGATGATGATGATGATGATGATGATGATGATGATGACGATGACGATGACGATGACGATGATGA	1
TGATGTTGATGATGATGATGATGATGATGATGATGACGATGACGATGACGATGATGA	1
TGATGTTGATGATGATGATGATGATGATGATGATGATGATGATGACGACGATGACGATGACGATGATGA	1
TGATGTTGATGATGATGATGATGGTGATGATGATGATGATGAGGATGACGATGACGATGACGAGGATGA	1
TGATGTTGATGATGATGATGATGATGATGATGATGATGATGTTGATGACGATGACGATGACGATGATGA	1
TGATGTTGATGATGATGTTGATGATGATGATGATGATGATGATGATGACGATGACGATGACGATGATGA	1
TGATGTTGATGATGATGATGATGATGATGATTATGATGATGATGATGACGATGACGATGACGATGATGA	1
TGATGTTGATGATGATGATGATGATGATGATGATGATGATGATGATGACGATGACGATAACGATGATGA	1
TGATGTTGATGATGATGATGATGATGATGATGATGATGATGATGATGACGATGACGATGGCGATGATGA	1
TGATGTTGATGATGATGATGATGATGATGATGATGATGATGATGATGACGATGACGATGACGCTGATGA	1
TGATGTTGATGATGTTGATGATGATGATGATGATGATGATGATGGTGACGATGACGATGACGATGATGA	1
TGATGTTGATGATGGTGATGATGATGATGATGATGATGATGATGATGACGATGACGATGACGATGATGA	1
TGATGTTGATGATGATGATGAAGATGATGATGATGATGATGATGATGACGATGACGATGACGATGATGA	1
TGATGTTGATGATGATGATGATGATGATGATGATGATGATGATGATGACGATGACGATGACAATGATGA	1
TGATGTTGATGATGATGATGCTGATTATGATGATGATGATGATGATGACGATGACGATGACGATGATGA	1
TGATGTTGATGATGATGATGCTGATGATGATGATGATGATGATGATGACGATGACGTTGACGATGATGA	1
TGATGTTGATGAAGATGAGGATGATGATGATGATGATGACGATGATGACGATGACGATGACGAGGATGA	1
TGATGTTGATGATGATGATGATGATGATGGTGATGATGATGATGATGACGATGACGATGACGATGATGA	1
TGATGGTGATGATGATGATGATGATGATGATGATGATGATGATGATGACGATGGCGATGACGATGATGA	1
TGATGTTGATGATGATGATGATGATGATGCTGATGATGATGATGATGACGATGACGATGACGATGATGA	1
TGATGTTGATGATGATGATGATGATGATGATGATGATGATGACGATGACGATGATGA	1
TGATGTTGATGATGATGATGATGATGATGATGATGATGATGATGATGACGATGACGACGACGATGATGA	1
TCATGTTGATGATGATGATGACGATGATGATGATGATGATGATGATGACGATGACGATGACGATGATGA	1
TGATGTTGATGATGATGATGATGATGATGATGGTGTTGATGATGATGACGATGTCGATGACGATGATGA	1
TGATGTTGATGATGATGCTGATGATGATGAGGATGATGATGATGATGACGAGGACGATGACGATGATGA	1
TGATGATGATGATGAAGATGATGATGATGAAGATGAAGATGATGATGACGATTACGATGACGATTATGA	1

Length variants:
69	357
66	10
63	2
57	2

