Subpop report generated 01-08-25 14:05:35

fastq:	/home/arthur/BioInf/Crypto_work/fastq/BM_paper_missing/BlooMine_RUNDIR/SRR11516701_WA5dBov99/Cp_gp60_IIa/SRR11516701_WA5dBov99.Cp_gp60_IIa_BMfiltered.fq
flanks_fasta flanks:	/home/arthur/BioInf/Crypto_work/fastq/BM_paper_missing/BlooMine_RUNDIR/tmp.Cp_gp60_IIa_flanks.fa


Sequence variants:
TGATGTTGATGATGATGATGATGATGATGATGATGATGATGATGATGACGATGACGATGATGA	95
TGATGTTGATGATGATGATGATGATGATGATGACGATGATGACGATGACGATGATGA	1
TGATGTTGATGATGATGATGATGATGATGATGATGATGATGATGATGACGATGACGATGTTGA	1
TGATGTTGATGATGATGATGATGATGATGATGATGATGATGACGATGACGATGATGA	30
TGCTGTTGATGATGATGATGATGATGATGATGATGATGATGATGACGATGACGATGATGA	1
TGATGTTGATGATGATGATGATGTTGATGCTGATGATGATGATGATGACGATGACGATGATGA	1
TGCTGCTGAGGATGATGATGATGATGATGATGATGATGACGATGACGATGATGA	1
TTATGTTGATGATGATGATGTTGATGATGATGATGATGCTGATGATGACGATGACGATGATGA	1
TGATGTTGATGATGATGATGATGATGATGATGATGACGATGACGATGATGA	2
TGATGTTGATGATGATGATGATGATGATGATGATGATGACGATGACGATGATGA	4
TGATGTTGATGAGGATGATGATGATGATGGTGATGATGATGATGATGACGGTGACGATGATGA	1
TGCTGTTGATGATGATGATGATGATGATGATGATGATGATGACGATGACGATGATGA	1
TGATGTTGATGATGATGATGATGATGATGATGATTATGATGATGATGACGATGACGATGATGA	1
TGATGTTGATTATGATGATGATAATGATGATGATGATGATGGTGATGACGGTGACGATGATGA	1
TGATGTTGATGATGATGATGATGATGATGATGATGATGATGATGACGATGACGATGATGA	16
TGATGTTGATGATGATGATGATGATGATGATGATGATGATGATGATGACGATGCCGATGCTGA	1
TGATGTTGATGATGATGATGATGATGATGAGGATGATGATGATGATGACGATGACGATGATGA	1
TGTTGTTGATGATGATGATGATGATGATGATGATGATGATGATGATGACGATGACGATGATGA	1
TGATGCTGGTGATGATGATGATGATGATGATGATGATGATGATGATGACGATGAGGATGATGA	1
TGATGTTGATGATGATGATGATGATGATGATGATGATGATGATGATGATGACGATGACGATGATGA	6
TGATGTTGATGATGATGATGATGATGATGATGATGATGATGATGATGACGATGACGATGACGATGATGA	2
TGCTGTTGATGATGATGATGATGATGATGCTGATGATGATGATGACGATGACGATGCTGA	1
TGATGTTGCTGATGATGATGATGATGATGATGATGATGATGACGATGACGATGATGA	1
TGCTGTTGATGCTGCTGATGATGATGATGATGCTGATGAGGATGATGACGATGACGATGATGA	1
TGATGGTGATGATGATGATGATGATGATGATGATGATGATGATGACGATGACGATGATGA	1
TGATGTTGATGATGATGATGATGATGATGGTGATGATGATGATGATGACGATGACGATGATGA	1
TGATGTTGATGATGATTATGATGAGGATGATGATGATGATGATTATGACGATGACTATGATGA	1
TGATGTTGATGATGATGATGATGATGATGATGATGATGATGATGACGATGACGATGCTGA	1
TGATGTTGATGATGATGATGATGATGATGATGATGATGATGATGATGATGATGACGATGACGATGATGA	2
TGATGTTGATGATGATGATGATGATGATGATGATGATGATGATGATGACGATGATGA	1
TGATGATGAGGATGATGATGAGGATGATGATGATGAGGATGATGATGATGACGATGACGATGATGA	1
TGATGTTGATGATGATGATGAGGATGATGATGATGATGATGATGATGACGATGACGATGATGA	1
TGATGTTGATGATGATGATGATGATGATGATGATGATGATGATGAGGACGATGACGATGATGA	2
TGATGTTGATGATGATGATGATGATGATGATGATTATGATGACGATGACGATGATGA	1
TGATGTTGATGATGATGATGATGATGATGATGATGATGATGATGATGATGACGATGACGATGATGC	1
TGCTGCTGATGATGACGATGATGATGATGATGATGATGATGATGATGACGATGACGATGATGA	1
TGATGTTGATGATGATGATGATGATGAAGATGATGATGATGACGATGACGATGATGA	1
TGATGTTGATGATGATGATGATGATGATGCTGATGATGATGATGATGCCGATGACGATGATGA	1
TGATGGTGATGAGGATGATGATGATGATGATGATGATGAGGATGATGACGATGACGATGATGA	1
CGATGTTGTTGATGATGATGCTGATGATGATGATGATGATGATGATGACGATGACGATGATGA	1
TGATGTTGCTGATGATGATGATGATGATGATGATGATGATGATGCTGACGATGACGATGATGA	1
TGATGTTGATGATGATGATGATGATGATGATGATGATGAGGACGATGACGATTATGA	1
TGATGTTGATGATGATGAGGATGATGATGATGATGATGATGATGATGACGATGACGATGATGA	2
TGATGTTGATGATGATGATGCTGATGATGATGATGATGATGATGATGACGATGACGATGATGA	1
TGACGTTGATGATGATGATGATGATGATGATGATGATGACGATGACGACGATGACGATGATGA	1
TGATGTTGATGATGATGATGATGATGATGATGATGATGATGATGATGACGATGACGATGATGC	1
TGATGTTGATGATGATGATGATGATGATGATGATGATGACGATGATGACGATGACGATGATGA	1
TGATGTTGAGGATGATGATGATGATGATGATGATGATGATGATGACGATGACGATGATGA	1
TGCTGTTGATGATGATGATGATGATGATGATGATGATGATGACGACGACGATGATGA	1
TGATGTTGAGGATGATGATGATGGTGATGATGATGATGATGATGGTGACGGTGACGATGATGA	1
TGATGTTGATGATGATGATGATGATGATGATGATAATGATGACGATGACGATGATGA	1
GGATGTTGATGATGATGATGATGATGATGATGATGATGATGAAGATGACGATGACGATGATGA	1
TGATATTGATGATGAGGATGATGATGAGGATGATGATGATGATGAAGACGATGACGATGATGA	1
TGATGTTGATGATGATGATGATGATGATGATGATGATGATGATGATGACGCTGACGATGATGC	1
TGATGTTGATGATGATGATGATGATGATGATGCTGATGATGATGATGACGATGACGATGATGA	1
TGATGTTGCTGATGATGATGATGATGATGATGATGATGATGATGATGACGATGACGATGATGA	1
TGATGTTGATGATGATGATGATGATGATGATGATGATGATGACGATGACGATGACGATGATGA	1
TGATGTTGATGATGCTGATGATGATGATGATGATGATGATGATGATGACGATGACGATGAGGA	1
TGATGTTGATGCTGATGATGATGATGATGATGATGATGATGACGATGACGATGATGA	1
TGATGTTGATGATGATGATGATGATGATGATGATGATCATGATGACGATTACGATGATGA	1
TGATGTTGATGATGATGATGATGATGATGATGATGATGATGATGATGATGATGACGATGATGA	1
TGATGTTGGTGATGATGATGATGATGATGATGATGATGATGACGATGAGGATGATGA	1
CGACGCTGATGATGTTGATGATGATGATTACGATGATGATGATGATGACGATGACGATGATGA	1
TGATGGTGATGCTGATGATGAAGATGATGCTGATGATGATGATGATGAAGATGACGATGATGA	1

Length variants:
63	133
57	41
60	22
54	5
51	2
66	8
69	4

