Subpop report generated 11-07-25 05:41:21

fastq:	/mnt/scratch45/sbiam21/all_crypto/bloomine/BlooMine_RUNDIR/SRR10363478_44534/Cp_gp60_IIa/SRR10363478_44534.Cp_gp60_IIa_BMfiltered.fq
flanks_fasta flanks:	/mnt/scratch45/sbiam21/all_crypto/bloomine/BlooMine_RUNDIR/tmp.Cp_gp60_IIa_flanks.fa


Sequence variants:
TGATGTTGATGATGATGATGATGATGATGATGATGATGATGATGATGACGATGACGATGATGA	154
TGATGTTGATGATGATGATGATGATGATGATGATGATGATGATGACGATGACGATGATGA	21
TGATGTTGATGATGATGATGATGATGATGATGACGATGATGATGATGACGATGACGATGATGA	3
TGATGTTGATGATGATGATGATGATGAAGATGATGATGATGATGATGATGACGATGACGATGATGA	1
TGATGTTGTTGATGATGATGATGATGATGATGATGATGATGATGATGACGATGACGATGATGA	2
TGATGTTGATGATGATGATGATGATGATGATGATGATGATGACGATGACGATGATGA	1
TGATGTTGATGATGATGATGATGATGAAGATGATGATGATGATGACGATGACGATGATGA	1
TGATGTTGATGATGCTGATGATGATGATGATGATGATGATGATGATGACGATGACGATGATGA	1
TGATGTTGATGATGATGATGATGATGATGATGATGATGATGATGATGATGACGATGACGATGATGA	5
TGATGTTGATGATGATGATGATGATGATGATGATGATGATGATGATGACGATGACGATGAAGA	1
TGATGTTGATGATGATGATGATGCTGATGATGATGATGATGATGATGACGATGACGATGATGA	1
AGATGTTGATGATGATGATGATGATGATGATGATGATGATGATGATGACGATGACGATGATGA	1
TGATGTTGATGTTGATGATGATGATGATGATGATGATGATGATGATGACGATGACGATGATGA	1
TGATGTTGATGATGATGATGATGATGATGATGATGATGATGATGATGACGATGACGATGATGG	1
TGTTGTTGTCGATGATGATGATTATGATGATGTTGATGATGATGATGACGATGACGACGAATA	1
TGATGTTGAACATGATGTTGATGATGATGAAGCTGAAGATGATGATGACGAAGACGATGATGA	1
TGGTGTTGATGATGATGATGATGATGATGATGATGATGATGATGATGACGATGACGATGATGA	1
TGATGTTGATGATGATGATGATGATGATGATGATGATGATGAGTATGACGATCACGATGATGA	1
TGATGTTGATGATGATGATGATGATGATTATGATGATGATGATGATGACGATGACGATGATGA	1
TGATGTTGATGATGATGATGATGATGATGACGATGATGATGATGATGATGACGATGACGATGATGA	1
AGATGTTGAAGATGATGATGATGATGATGATGATGATGATGATGACGATGACGATGATGA	1
TGATGTTGATGATGATGATGATGATGATGATGATGCTGATGATGATGACGATGACGATGATGA	1
TGAAGTTGGTGAAGATGATGATGCCGATGATGATGATGATGATGATGACGATGACGATGATGA	1

Length variants:
63	172
60	23
66	7
57	1

