Subpop report generated 09-07-25 16:44:31

fastq:	/home/amorris/BioInf/BlooMine_WD/BlooMine_paper_reanalysis/gp60_all/SRR26320753_DK1_grouped.CP044417_263000-268000/Cp_gp60_IIa/SRR26320753_DK1_grouped.CP044417_263000-268000.Cp_gp60_IIa_BMfiltered.fq
flanks_fasta flanks:	/home/amorris/BioInf/BlooMine_WD/BlooMine_paper_reanalysis/gp60_all/tmp.Cp_gp60_IIa_flanks.fa


Sequence variants:
TGATGTTGATGATGATGNTGATGATGATGGTGATGACGATGACGATGACGATGATGA	1
TGATGTTGATGATGATGATGATGATGATGATGATGATGACGATGACGATGACGATGATGA	9
TGATGTTGATGATGATGATGATGATGATGATGATGATGATGACGATGACGATGACGATGATGA	155
TGATGTTGATGATGATGATGATGATGATGATGCTGATGATGACGATGACGATGACGATGATGA	1
TGATGTTGATGATGATGATGATGATGATGATGATGATGATGATGACGATGACGATGACGATGATGA	3
TGATGTTGATGATGATGATGATGATGATGATGATGATGATGACGATGACGATGACGAGGATGA	1
TGATGTTGATGATGATGATGATGATGATGATGATGATGATGATGACGATGACGATGATGA	1
TGATGTGGATGATGATGATGATGATGATGATGATTATGATGACGATGACGATGACGATGATGA	1
TGATGNTGATGATGATGATGATGATGATGATGATGATGATGACGATGACGATGACGATGATGA	1
TGATGTTGATGATGATGATGATGATGATGATGACGATGATGATGACGATGACGATGACGATGATGA	1
TGATGTTGATGATGATGATGATGATGATGATNATGATGATGACGATGACGATGACGATGATGA	1
TGATGTTGATGATGATGATGATGACGATGACGATGACGATGATGA	1
TGATGTTGATGATGATGATGATGATGATGACGATGATGATGACGATGACGATGACGATGATGA	1
TGATGTTGATGATGATGATGATGATGATGATGATGACGATGACGATGACGATGATGA	2
TGATGTTGATGATGATGATGATGATGATGATGATGATGATGATGATGATGATGACGATGACGATGACGATGATGA	1
TGATGTTGATGATGATGATGATGATGATGATGATGATGATGACGAGGACGATGACGATGATGA	2
TGATGTTGATGATGATGATGATGATGATGATGATGATGATGACGATGACGATGACGTTGATGA	1
TGATGTTGATGATGAGGATGATGATGATGATGATGATGACGATGACGATGACGATGATGA	1
TGATGTTGATGATGATGATGANGATGATGATGANGATGATGACGATGACGATGACGATGATGA	1
NGATGTTGATGATGATGATGATGATGATGATGATGATGATGACGATGACGATGACGATGATGA	1
TGATGTTGATGATGATGATCATGATGATGATGATGATGATGACGATGACGATGACGATGATGA	1
TGNTGTTGATGATGATGATGATGATGATGATGATGATGATGACGATGACGATGACGATGATGA	1
TGATGTTGATGATGATGATGATGATGATGATGATGATGACGATGACGATGACGAAGATGA	1
TGATGTTGATGATGATGATGATGATGATGATGNTGATGAGGACGATGACGATGACGATGATGA	1
TGATGTTGATGATGATGATGATGATGATGATGNTGATGATGACGATGACGATGACGATGCTGA	1
TGACGTTGATGATGATGATGATGATGATGATGATGATGATGACGATGACGATGACGATGATGA	1
TGATGGTGATGATGATGATGATGCTGATGATGATGATGATGACGATGACGATGACGATGATGA	1
TGATGTTGATGATGATGATGATGATGATGATGATGCTGATGANGATGACGATGACGATGATGA	1
TGATGTTGATGATGATGATGATGNTGATGATGATGATGATGACGATGACGATGACGATGATGA	1
TGATGTNGATGATGATGATGATGATGATGATGATGATGACGATGACGATGACGATGATGA	1
TGATGTTGATGATGATGTTGATGATGATGATGATGATGATGACGATGACGATGACGATGATGA	1
TGATGTTGATNATGATGATGATGATGATGATGATGATGATGACGAGGACGATGACGATGATGA	1

Length variants:
57	3
60	13
63	176
66	4
45	1
75	1

