Subpop report generated 09-07-25 16:28:13

fastq:	/home/amorris/BioInf/BlooMine_WD/BlooMine_paper_reanalysis/gp60_all/SRR26320662_Swe3_grouped.CP044417_263000-268000/Cp_gp60_IIa/SRR26320662_Swe3_grouped.CP044417_263000-268000.Cp_gp60_IIa_BMfiltered.fq
flanks_fasta flanks:	/home/amorris/BioInf/BlooMine_WD/BlooMine_paper_reanalysis/gp60_all/tmp.Cp_gp60_IIa_flanks.fa


Sequence variants:
TGATGTTGATGATGATGATGATGATGATGATGATGATGACGATGACGATGATGA	11
TGATGTTGATGATGATGATGATGATGATGATGATGATGATGACGATGACGATGATGA	100
TGATGTTGATGATGATGATGATGATGATGATGATGATGATGATGACGATGACGATGATGA	179
TGATGTTGATGATGATGATGATGTTGATGATGATGATGATGACGATGACGATGATGA	1
TGAGGTTGATGATGATGATGATGATGATGATGATGATGATGATGACGATGACGATGATGA	2
TGATGTTGATGATGATGATGCTGATGATGATGATGATGATGATGACGATGACGATGATGA	1
TGATGTTGATGATGATGATGATGATGATGATGATGATGATGATGATGACGATGACGATGATGA	1
TGATGTTGATGATGATGATGATGATGATGATGATGATGATGATGATGATGACGATGATGA	3
TGATGTTGATGATGATGATGATGATGATGATGATGACGATGACGATGATGA	1
TGATGTTGATGATGATGATGATGATGATGATGATGAGGATGACGATGACGATGATGA	1
TGATGTTGATGATGATGATGATGATGATGATGATGANGATGATGACGATGACGATGATGA	1
TGATGTTGATGATGATGATGATGATGATGATGATGATGATGACGATGACGCTGATGA	1
TGATGTTGAGGATGATGATGATGATGATGATGATGATGATGATGGTGACGATGACGATGATGA	1
TGATGTTGATGATGATGATGATGATGATGATGATGATGATGATGACGATGNCGATGATGA	1
TGATGTTGATGATGATGATGATGATGATCATGATGATGACGATGACGATGATGA	1
TGATGTTGATGATGATGATGATGATGATGATGATGATGATGACGATTACGATGATGA	1
TGATGTTGATGGTGATGATGATGATGATGATGATGATGATGATGACGATGACGATGATGA	1
TGATGTTGATGATGATGATGATGATGATGATGATGATGATGNTGACGATGACGATGATGA	1
TGATGTTGATGATGATGATGATGATGATGATGATGAGGATGATGACGATGACGATGATGA	1
TGATGTTGATGATGATGATGATGATGATGATGATGCTGATGACGATGACGATGATGA	1
TGATGATGATGATGATGATGATGATGATGACGATGATGATGATGACGATGACGATGATCA	1
TGATGTTGATGATGATGATGATGATGATGATGATGATGATGATGACGATGACGATGATCA	2
TGATGTTGATNATGATGATGATGATGATGATGATGATGATGATGACGATGACGATGATGA	1
TGATGTTGATGATGATGATGATGATGATGATGATGATGATGCTGACGATGACGATGATGA	1
TGATGTTGATGATGATGANGATGATGATGATGATGATGATGACGATGACGATGATGA	1
TGATGTTGATGATGATGATGATGATGATGATGATGATGATGACGAGGACGATGATGA	2
TGATGTTGATGCTGATGATGATGATGATGATGATGATGATGACGATGACGATGATGA	1
TGATGTTGATGATGATGATGATGATGATGATGATGATGATGATGATGACGATGATGA	1
TGATGTTGATGATGATGATGATGATGATGATGATGATNACGATGACGATGATGA	1
TGATGTTGATGATGATGATGATGATGATGACGNTGACGATGATGA	1
TGATGTTGATGATGATGATGATGATGATGATGATGATGAGGACGATGACGATGATGA	3
TGATGTTGATGATGATGATGATGATGATGATGATGATGATGATGACGANGACGATGATGA	1
TGATGTTGATGATGATGATGATGATGATGATGATGATGATGATGANGATGACGATGATGA	1
TGATGTTGATGATGATGATGATGATGTTGATGATGATGATGATGACGATGACGATGATGA	1
TGATGTTGATGATGATGATGATGATGATGATGATGACGATGACGATGGTGA	1
TGATGTTGATGATGATGATGATGACGATGACGATGATGA	1
TGATGTTGATGATCATGATGATGATGATGATGATGATGATGACGATGACGATGATGA	1
TGATGTTGATGATGATGATGATGACGATGATGATGATGATGACGATGACGATGATGA	1
TGATGTTGANGATGATGATGATGATGATGATGATGATGATGACGATGACGATGATGA	1
TGATGTTGATGATNATGATGATGATGATGATGATGATGATGACGATGACGATGATGA	1
TGGTGTTGATGATGATGATGATGATGATGATGATGATGATGACGATGACGATGATGA	1
TGATGTTGATGATGATGNTGATGATGATGATGATGATGATGACGATGACGATGATGA	1
TGATGGTGATGATGATGATGATGATGATGATGATGATGATGATGACGATGACGATGATGA	1
TGAGGTTGATGATGATGATGATGATGATGATGATGATGATGACGATGACGATGATGA	1
TGATGNTGATGATGATGATGATGATGATGATGATGATGATGATGACGATGACGATGATGA	1
TGATGTTGATGATGATGGTGATGATGATGATGATGATGATGATGACGATGACGATGATGA	1
TGATGTTGATGATGATGATGATGATGATGATGATGATGATGATGATGATGACGATGACGATGATGA	1
TGATGTTGATGATGATGATGATGATGATGATGATGATGATGATGACGATGACGGTGATGA	1
TGATGTTGATGATGATGATGATGATGAGGATGATGATGATGACGATGACGATGATGA	1
TGATGTTGATGATGATGATCATGATGATGATGATGATGATGACGATGACGATGATGA	1
TGATGTTGATGATGATGATGATGATTATGATGATGATGATGATGATGACGATGACGATGATGA	1
TGATGTTGATGATGATGATGATGATGATGATGATGATGATGATGACGATGATGA	1
TGATGTTGATGATGATGATGATGATGATGATGATTATGATGATGACGAGGTCGATGATGT	1
TGATGTTGATGATGATGATGATGAGGATGATGATGATGATGATGACGATGACGATGATGA	1
TGATGTTGATGATGATGATGATGATGATGATGATGATGATGACTATGACGATGATGA	1
TGATGTTGATGATGATGATGATGATGATGATGATGATGATGATGACNATGACGATGATGA	1
TGATGTTGATGATGATGATGATGATGATGATGATGATGATGAAGTTGACGATGATGA	1
TGATTTTGATGATGATGATGATGATGATGATGATGATGAGGACGATGACGATGATGA	1
TGATGATGATGATGATGATGATGATGATGATGATGATGATGACGATGACGATGATGA	1
TGATGTTGATGATGATGATGATGATGATGATGATGATGATGATGACGATGACGANGATGA	1
TGATGTTGATGATGATGATGATGATGATGAAGATGATGATGATGACGATGACGATGATGA	1
TGATGTTGATGATGATGATGATGATGANGATTATGATGATGATGACGATGACGATGATGA	1
TGATGTTGATGATGATGATGATGATGATGATGATGATGATGATGACGAGGACGATGATGA	1
TGATGTTGATGATGACGATGATGATGATGATGATGATGATGACGATGACGATGATGA	1
TGATGTTGATGATGATGATGATGATGATGATGATGATGATGACGCTGACGATGATGA	1
TGATGTGGATGATGATGATGATGATGATGATGATGATGATGACGATGACGATGATGA	1
TGATGTTGATGATGATGATGATGATGAAGATGATGATGATGATGACGATGACGATGATGA	1
TGATGTTGATGATGATGATGATGATGATNATGATGATGATNATGCCGATGACGATGATGA	1
TGATGTTGATGATGATGATGATGATGATGATGATGATGAAGATGACGAGGACGCTGATGA	1
TGATGTTGATGATGAAGATGATGATGCTGATGATGATGACGATGACGATGATGA	1

Length variants:
54	15
57	129
60	212
63	3
51	2
45	1
39	1
66	1

