Subpop report generated 09-07-25 13:51:38

fastq:	/home/amorris/BioInf/BlooMine_WD/BlooMine_paper_reanalysis/gp60_all/SRR26320705_FIN23_grouped.CP044417_263000-268000/Cp_gp60_IIa/SRR26320705_FIN23_grouped.CP044417_263000-268000.Cp_gp60_IIa_BMfiltered.fq
flanks_fasta flanks:	/home/amorris/BioInf/BlooMine_WD/BlooMine_paper_reanalysis/gp60_all/tmp.Cp_gp60_IIa_flanks.fa


Sequence variants:
TGATGTTGATGATGATGATGATGATGATGATGATGACGATGACGATGATGA	253
TGATGTTGATGATGATGATGATGATGATGATGAGGACGATGACGATGATGA	2
TGATGTTGATGATGATGATGATGATGATGATGATGACGAGGACGATGATGA	2
TGATGTTGATGATGATGATGATGATGATGATGATGACGATGACAATGATGA	2
TGATGTTGATGATGATGATGATGATGATGCTGATGACGATGACGATGATGA	2
TGTTGTTGATGATGATGATGATGATGATGAGGATGACGATGACGATGATGA	1
TGATGTTGATGATGATGAGGATGATGATGATGATGACGATGACGATGATGA	1
TGATGTTGTTGATGATGTTGAGGATGATGAGGATGACGATGACGACGATGA	1
TGATGTTCATGATGATGATGATGATGATGATGATGACGATGACGATGATGA	1
TGATGTTGATGATGATGATGATGCTGATGATGATGACGATGACGTTGATGA	1
TGAGGTTGATGATGATGATGATGATGATGATGATGACGATGACAATGATGA	1
TGATGTTGATGATGATGATTATGATGATGATGACGATGACGATGATGA	1
TGATGTTGATGATGATGATGATGATGAGGATGATGACGATGACGATGATGA	1
TGATGTTGATGATGATGATGATGATGATGATGATGCCGATGACGATGATGA	1
TGATGTTGATGATGATGATGATGCTGATGATGATGACGATGACGATGATGA	1
TGATGTTGATGATGATGATGATGATGATGATGACGATGACGATGATGA	9
TGATGTTGATGATGATGATGATGAGGATGATGATGACGATGACGATGATGA	2
TGATGTTGATGATGATGATGATGATGATGATGATGACGAAGACGATGATGA	1
TGATGTTGATGATGATGATGATGATGATGATGATGACGATGAGGATGATGA	1
TGAGGTTGATGATGATGATGATGATGATGATGATGACGATGACGATGATGA	1
GGATGATGATGAAGATGATGATGATGATGATGATGACGATGACGATGATGA	1
TGATGTTGATGATGATGATGATGATGATGATGATGACGCTGACGATGATGA	1
TGATGTTGATGATGCTGATGATGATGATGATGATGCCGATGACGATGATGA	1
TGATGTTGATGATGATGAGGATGATGATGATGCTGACGATGACGATGATGA	1
TGATGTTGAGGATGATGATGATGATGATGATGATGACGATGACGATGATGA	2
TGATGTTGATGATGATGATGATGATGATGATGCTGACGATGACGATGATGA	1
TGATGGTGATGATGATGATGATGATGATGATGATGACGATGACGATGATGA	1
TGATGTTGATGATGATTATGATGATGATGATGATGACGATGACGATGATGA	1
TGATGTTGATGTTGATGATGATGATGATGATGACGATGACGATGATGA	1
TGATGTTGATGATGCTGATGATGATGATGATGATGACGATGACGATGATGA	1
TGATGTTTATGATGATGATGATGATGAAGATGATGACGATGACTATGAAGA	1

Length variants:
51	286
48	11

