Subpop report generated 09-07-25 12:16:41

fastq:	/home/amorris/BioInf/BlooMine_WD/BlooMine_paper_reanalysis/gp60_all/SRR26320682_Hun12_grouped.CP044417_263000-268000/Cp_gp60_IIa/SRR26320682_Hun12_grouped.CP044417_263000-268000.Cp_gp60_IIa_BMfiltered.fq
flanks_fasta flanks:	/home/amorris/BioInf/BlooMine_WD/BlooMine_paper_reanalysis/gp60_all/tmp.Cp_gp60_IIa_flanks.fa


Sequence variants:
TGATGTTGATGATGATGATGATGATGATGATGATGATGATGATGACGATGATGATGA	230
TGATGTTGATGATGATGATGATGATGATGATGATGATGACGATGATGATGA	5
TGATGTTGATGATGATGATGATGATGATGATGATGATGATGCTGACGATGATGATGA	2
TGATGTTGATGATGATGATGATGATGATGATGATGATGATGATGATGACGATGATGATGA	13
TGATGTTGATGATGATGATGATGATGATGATGATGATGATGCTGCCGATGATGATGA	1
TGATGTTGATGATGATGGTGATGATGATGATGATGATGATGATGACGATGATGATGA	1
TGATGTTGATGATGATGATGATGATGATGATGATGATGATGACGATGACGATGACGATGATGA	10
TGATGTTGATGATGATGATGATGATGATGATGATGATGATGACGATGATGATGA	16
TGATGTTGATGATGATGATGATGATGATGATGATGATGATGATGACGACGATGATGA	1
TGATGTTGATGATGATGATGAGGATGATGATGATGATGATGATGACGATGATGATGA	1
TGATGTTGATGATGATGATGATGATGATGATGATGTTGATGATGACGATGATGATGA	1
TGATGTTGATGATGATGATGATGATGATGATGATGATGATGATGACGAGGATGATGA	1
TGATGTTGATGATGATGATGATGATGATGATGATGATGATGATGACGATGATGCTGA	1
TGATGTTGATGATAATGATGGTGANGATGATGATGATGATGATGACGATGATGATGA	1
TGATGTTGATGATGATGATGACGATGATGATGATGATGATGATGACGATGATGATGA	1
TGATGTTGATGATGATGCTGATGATGATGATGATGATGATGATGACGATGATGATGA	1
TGATGATGATGATGATGATGATGATGATGATGATGATGAGGATGACGATGATGATGA	1
TGATGTTGATGATGTTGATGATGATGATGATGATGATGATGACGATGACGATGACGATGATGA	2
TGTTGTTGATGATGATGATGATGATGATGATGATGATGATGATGACGATGATGATGA	1
TGATGTTGATGCTGATGATGATGATGATGATGATGCTGATGATGACGATGATGATGA	1
TGATGTTGATGATGATGATGATGATGATGATGATGATGACGATGACGATGATGATGA	2
TGATGTTGATGATGATNATGATGATGATGATGATGATGCTGATGACGATGATGATGA	1
TGATGTTGATGATGATGATGCTGATGATGATGATGATGATGATGACGCTGATGATGA	1
TGATGTTGATGATGATGATGATGATGATGATGATGCTGATGATGACGATGATGATGA	2
TGATGTTGATGATGATGATGATGATGATGCTGATGATGATGATGACGATGATGATGA	1
TGATGTTGATGNTGATGATGATGATGATGATGATGATGATGATGACGATGATGATGA	1
TGATGTTGATATTGATGATGATGATGATGATGATGATGATGATGACGATGATGATGA	1
TGATGTTGATGATGATGATGATGATGATGATGACGATGATGATGA	1
TNATGTTGATGATGATGATGATGATGATGATGATGANGATGACGATGATNATGA	1
TGATGTTGATGATGATGTGGATGATGATGATGATGATGATGATGACGATGATGATGA	1
TGATGTTGATGATGCTGATGATGATGATGATGATGATCATGATGACGATGATGATGA	1
TGATGTTGATGATGATGATGTTGATGATGATGATGATGATGATGACGATGATGATGA	1
TGAGGTTGATGATGATGATGATGATGATGATGATGATGATGATGACGATGATGATGA	1
TGATGTTGATGATGATGATGATGATGATGACGATGATGATGA	1
TGATGTTGATGATGATGATGATGATGATGAGGATGATGATGATGACGATGATGATGA	1
TGATGTTGNTGATGATGATGATGATGATGATGATGATGATGATGATGATGACGATGATGATGA	1
TGATGTTGATGATGATGATGATGATGATGATGATGACGATGATGATGACGATGATGATGA	1
TGATGTTGATGATGATGACGATGATGATGATGATGATGATGATGACGATGATGATGA	2
TGATGTTGATGATGATGATGATGATGATGATGATGATGATGAAGACGATGATGATGA	1
TGATGTGGATGATGATGATGATGATGATGATGATGATGATGATGACGATGATGATGA	1
TGATGTTGATGATGATGATGATGATGATGATGATNATGACGATGATGATGA	1
TGATGTTGATGATGATGATGATGATGATGTTGATGATGATGATGACGATGATGATGA	2
TGATGTTGATGATGATGATGATGATGATGATGAGGATGATGATGACGATGATGATGA	1
TGATGTTGATGATGATGATGATGATGATGATGGTGATGATGATGTCGATGATGATGA	1
TGATGTTGATGATGATGATGATGATGATGATGCTGATGATGATGACGATGATGATGA	1
TGATGTTGATGATGATGATGATGATGATGATGGTGATGATGATGACGATGATGATGA	1
TGATGTTGATGATGATGATGATGATGATGTTTATGATGATGATGACGATGATGATGA	1
TGATGTTGATGATGATGATGATGATGATGATGATNATGATGATGACGATGATGATGA	1
TGATGTTGATGATGATGATGATGATGATGATGATGATGATGATGACGGTGATGATGA	1
TGATGTTGATGATGATGATGATGATGATGATGATGATGATGATGACGCTGATGATGA	1
TGATGTTGATGATGATGATGATGATGATGGTGATGATGATGATGACGATGATGATGA	1
TGATGTTGATGATGATGATGATGATGATGATGATGACGATGATGATGA	2
TGATGTTGATGATGATGNTGATGATGATGATGATGATGATGATGACGATGATGATGA	3
TGATGTTGATGATGATGATGATGNTGATGATGATGATGATGACGATGATGATGA	1
TGATGTTGATGATGATGATGATGATGATGATGATGATGATCATGACGATGATGATGA	1

Length variants:
57	278
51	6
60	14
63	13
54	18
45	1
42	1
48	2

