Subpop report generated 09-07-25 12:11:01

fastq:	/home/amorris/BioInf/BlooMine_WD/BlooMine_paper_reanalysis/gp60_all/SRR26320667_Pol2_grouped.CP044417_263000-268000/Cp_gp60_IIa/SRR26320667_Pol2_grouped.CP044417_263000-268000.Cp_gp60_IIa_BMfiltered.fq
flanks_fasta flanks:	/home/amorris/BioInf/BlooMine_WD/BlooMine_paper_reanalysis/gp60_all/tmp.Cp_gp60_IIa_flanks.fa


Sequence variants:
TGATGTTGATGATGATGATGATGATGATGATGATGATGACGATGATGATGA	1
TGATGTTGATGATGATGATGATGATGATGATGATGATGATGATGACGATGATGATGA	10
TGATGTTGATGATGATGATGATGATGATGATGATGATGATGATGACGATGAGGATGA	1
TGATGTTGATGATGATGATGATGATGCTGATGATGATGATGATGATGACGATGATGATGA	1
TGATGTTGATGATGATGATGATGATGATGATGATGATGATGATGATGACGATGATGATGA	157
TGATGTTGATGATGATGATGATGATGATGATGATGATGATGATGAGGACGATGAGGATGA	1
TGATGTTGATGATGATGATGATGATGATGATGATGATGATGATGATGTCGATGATGATGA	1
TGATGTTGATGATGATGATGATGATGATGATGATGATGATGATGATGACGATGATGATGN	1
TGATGTTGATGATGATGATGATGATGATTATGATGATTATGAAGATGACGAAGATGATGA	1
TGATGTTGATGATGATGATGATGATGATGATGATGATGATGATGAGGACGAGGATGATGA	1
TGATGTTGATGATGATGATGATGATGATGATGATGATGATGACGATGATGATGA	4
TGATGTTGATGATGATGATGATGATGATGATGATGATGAGGATGATGACGATGATGATGA	2
TGATGTTGCTGATGATGATGATGATGATGATGATGATGATGATGATGACGATGATGATGA	1
TGATGTTGATGATGATGATGATGATGATGATGCTGATGATGAGGCTGACGATGATGATGA	1
CGATGTTGATGATGATGATGATGATGATGATGATGATGATGATGATGACGATGATGATGA	1
TGATGTTGATGATGATGATGATGATGATGATGATGATGATGATGATGACGATGATGCTGA	2
TGATGTTGATGATGATGNTGATGATGATGATGATGATGATGATGATGACGATGATGATGA	2
TGATGTTGATGATGATGATGATGATGATGATGATGATGATGATGATGCCGATGATGATGA	1
TGATGTTGATGATGATGATGATGCTGCTGATGCTGATGATGATGATGACGATGATGATGA	1
TGATGTTGATGATGATGATGATGATGATGATGATGATGATGATGATGACGATGATGATGC	1
TGATGTTGATGATGATGATGATGATGATGATGATGATGATGCTGACGATGATGATGA	1
TGAAGTTGATGATGATGATGATGATGATGATGATGATGATGATGACGATGATGATGA	1
TGATGTTGATGATGATGATGATGATGATNATGATGATGATGATGACGATGATGATGA	1
TGATGTTGATNATGATGATGATGATGATGATGATGATGATGATGATGACGATGATGATGA	1
TGATGTTGATGATGATGATGATGATGATGATGATGATGATGATGAGGAAGATGATGATCA	1
TGATGTTGATGATGATGATGATGATGATGATGATGATGATGATGATGACGATGCTGATGA	1
TGATGTTGATGATGATGATGATGATGATGATGATGCTGATGATGATGACGATGATGATGA	2
TGATGTCGATGATGATGATGATGATGATGATGATGATGATGATGATGACGATGATGATGA	1
TGATGTTGATGATGATGATGATGCTGATGATGATGATGATGATGACGATGATGATGA	1
TGATGTTGATGATGATGATGATGAAGATGATGATGATGATGATGATGACGATGATGATGA	1
TGATGTTGATGATGATGATGATGATGATGATGATGATGATGCTGATGACGATGATGATGA	1
TGATGTTGATGATGATGATGATGCTGATGATGATGATGATGATGATGACGATGATGATGA	1
TGATGTTGATGATGATGATGATGATGATGATGATGATGATGATGCTGACGAGGATGATGA	1
TGATGTTGATGATGATGATGATGATGATGATGATGACGATGATGATGA	1
TGATGTTGATGATGCTGATGATGATGATGATGATGATGATGATGATGACGATGATGATGA	2
TGTTGTNGATGATGATGATGATGATGATGATGATGATGATGATGATGACGATGTTGATGA	1
TGATGTTGATGATGATGATGATGATGATGATTATGATGATGATGATGACGAGGATGATGA	1
TGATGTTGATGATGATGATGATGATGATGATGATGATGATGATGATGACGATGATTATGA	1
TGATGTTGATGATGATGATGATGATGATGATGATGATGATGATGATGATGACGATGATGATGA	1
TGATGTTGATGATNATGATGATGATGATGATGATGATGATGATGATGACGATGATGATGA	2
TGATGTTGATGATGATGATGATGATGATGATGATGATGATGATTATTACGATGATGATGA	1
TGATGTTGATGATGATGATGATGATGATGATGATGATGATGATGATGACGATGATGAGGA	2
TGATGTTGNTGATGATGATGAAGATGATGATGATGATGATGATGATGACNATGATGATGA	1
TGATGTTGATGATGATGATGATGATGATGATGATAATGATGATGACGATGATGATGA	1
TGATGTTGATGATGATGATGATGATGATGATGATGATGATGATGATGACGANGATGATGA	1
TGATGTTGATGATGATGATGATGATGATGATGATGATGATGATGATGACGATGATGACGA	1
TGATGTTGATGATGATGATGATGATGATGATGATGATGATGGTGATGACGATGATGATGA	1
TGATGTTGATGATGATGATGATGATGATGATGATGATGATGATGATGACGATCATGATGA	1
TGATGTTGATGATGATGATGATGATGATGATGATGATGATNATGATGACGATGATGATGA	1
TGAGGTTGATGATGATGATGATGATGATGATGATGATGATGATGATGATGACGATGATGATGA	1
TGATGTTGATGATGATGATGATGATGATGATGATGATGATGCTGATGACGNTGATGATGA	1
TGATGTTGATGATGATGANGATGATGATGATGATGATGATGAGGATGACGATGATGATGA	1
TGATGTTGATGATGATGATGATGATGATGATGCTGCTGATGATGATGCCGATGATGCTGA	1
TGATGTTGATGATGATGATGATGATGATGATGATGATGATGANGATGACGATGATGATGA	1
TGATGTTGATGATGATGATGATGATGATGATGATGATGATGATGATGATGACGAAGATGATGA	1
TGTTGTTGATGATGATGATGATGATGATGATGATGATGATGAGGATGACGTTGATGATGT	1
TGATGTTGATGATCATGATGATGATTATGATGATGATGATGATGACGATGATGATGA	1
TGATGTTGATGATGATGATGATGATGATGATGATGATGATGATGATGACGATGCTGCTGA	1
TGATGTTGATGATGATGAGGATGATGATGATGATGATGATGATGATGACGATGATGATGA	1
TGATGTTGATGATGATGATGATGCTGATGATGATGATGATGATGACGCTGATGATGA	1
TGATGTTGATGATGATGATGATGANGATGATGATGATGATGATGATGACGATGATGATGA	1
TGATGTTGATGATGATGATGATGAAGATGATGATGATGATGATGATGACGANGATGATGA	1
TGATGTTGATGATGATGATGATGATGATGATGATGTTGATGATGATGTCGATGATGATGA	1
TGATGTAGATGATGATTCTGATGATGTTGAGTATGATGATGATGATGACGATGATGATGA	1

Length variants:
51	1
57	18
60	212
54	4
48	1
63	3

