Subpop report generated 09-07-25 13:03:22

fastq:	/home/amorris/BioInf/BlooMine_WD/BlooMine_paper_reanalysis/gp60_all/SRR21763628_Calf6_grouped.CP044417_263000-268000/Cp_gp60_IIa/SRR21763628_Calf6_grouped.CP044417_263000-268000.Cp_gp60_IIa_BMfiltered.fq
flanks_fasta flanks:	/home/amorris/BioInf/BlooMine_WD/BlooMine_paper_reanalysis/gp60_all/tmp.Cp_gp60_IIa_flanks.fa


Sequence variants:
TGATGTTGATGATGATGATGATGATGATGATGATGATGATGATGATGACGATGACGATGATGA	5
TGATGTTGATGATGATGATGATGATGATGATGATGATGATGATGATGATGACGATGACGATGATGA	112
TGATGTTGATGATGATGATGATGATGATGATGATGATGATGATGATGATGAAGAGGACGATGATGA	1
TGATGTTGATGATGATGATGATGATGCTGATGATGATGATGATGATGATGACGATGACGATGATGA	1
TGATGTTGACGATGATGATGATGATGATGAGGATGATGATGATGAGGATGACGATGACGATGATGA	1
TGATGTTGATGATGATGATGATGATGATGATGATGATGATGATGATGATGAAGATGACGATGATGA	2
TGATGTTGATGATGCTGATGATGATGAGGATGATGATGATGATGATGATGACGATGACGATGATGA	1
TGATGTTGATGATGATGATGATGATGATGATGATGATGATGATGAGGATGACGATGACGATGATGA	2
TGATGTTGATGATGATGATGACGATGACGATGATGA	1
TGATGTTGATGATGATGATGATGATGATGATGATGATGATGATGATGATGACGATGACGATGAAGA	1
TGATGTTGATGATGATGATGATGATGATGATGATGATGATGATGATGATGACGAGGACGATGATGA	1
TGATGTTGATGATGATGATGATGATGATGATGATGATGATGATGATGATGATGACGATGACGATGATGA	1
TGATGTTGATGATGATGATGATGATGATGATGATGATGATGATGCTGATGACGATGACGATGATGA	1
TGATGTTGTTGATGATGATGATGATGATGATGATGATGATGATGTTGATGACGATGACGATGATGA	1
TGATGTTGATGATGATGATGCTGATGATGATGATGATGATGATGATGATGACGATGACGATGATGA	1
TGATGTTGATGATGATGATGATGATGATGATGATGATGATGATGAGGATGACGATGACGATGAGGA	1
TGATGGTGATGATGATGATGATGATGATGATGATGATGATGATGATGATGACGATGACGATGATGA	1
TGATGTTGCTGATGATGATGATGATGATGATGATGATGATGATGATGATGACGATGACGATGATGA	1
TGATGTTGATGATGATGATGATGATGATGATGATGATGATAATGATGATGACGATGACGATGATGA	2
TGATGTTGATGATGATGATGATGATGAGGATGATGATGACGCTGATGCTGACGATGACGATGATGA	1
TGATGGTGATGATGATGCTGATGATGATGATGATGATGATGATGATGATGACGATGACGATGATGA	1
TGATGTTGATGATGATGATGATGATGATGATGATGATGATGATGATGCTGACGATGACGATGATGA	1
TGATGTGGATGAAGAGGATGATGATGATGATGATGATGATGAGGATGATGACGATGACGATGATGA	1
TGATGTTGATGATGATGATGATGATGATGATGATGATGATGAGGCTGATGACGATGACGATGATGA	1

Length variants:
63	5
66	135
36	1
69	1

