Subpop report generated 09-07-25 16:52:18

fastq:	/home/amorris/BioInf/BlooMine_WD/BlooMine_paper_reanalysis/gp60_all/SRR26320664_Swe1_grouped.CP044417_263000-268000/Cp_gp60_IIa/SRR26320664_Swe1_grouped.CP044417_263000-268000.Cp_gp60_IIa_BMfiltered.fq
flanks_fasta flanks:	/home/amorris/BioInf/BlooMine_WD/BlooMine_paper_reanalysis/gp60_all/tmp.Cp_gp60_IIa_flanks.fa


Sequence variants:
TGATGTTGATGATGATGATGATGATGATGATGATGATGATGACGATGACGATGATGA	297
TGATGTTGATGATGANGATGATGATGATGATGATGATGATCACGATGACGATGATGA	1
TGATGTTGATGATGATGATGATGATGCTGATGATGATGATGACGATGACGATGATGA	1
TGATGTTGATGATGATGATGATGATGATGACGATGATGATGACGATGACGATGATGA	1
TGATGTTGATGATGATGATGATGATGATGATGATGATGATGACGATGACGATGACGA	1
TGATGTTGATGATGATGATGATGATGATGATGATGATGATGACGAAGACGATGATGA	1
TGATGTTGATGATGATGATGATGATGATGATGATGATGACGATGACGATGATGA	18
TGATGTTGATGATGATGATGATGATGATGATGATGATGATGATGACGATGATGA	1
TGATGTTGATGATGATGATGATGATGATCATGATGATGATGACGATGACGATGATGA	1
TGATGTTGATGATGATGATGATGATGATGATGATGATGATGATGACGATGACGATGATGA	7
TGATGTTGATGATGATGATGAGGATGATGATGATGATGATGACGATGACGATGATGA	1
TGATGTTGATGATGATGATGATGGTGATGATGATGATGACGATGACGATGATGA	1
TGATGTTGATGATGATGATGATGATGATGATGACGATGACGATGATGA	2
TGATGTTGATGATGATGATGATGATGATGATGATGANGACGAAGACGATGATGA	1
TGATGTTGATGATGATGATGATGATGATGATGATGATGATGACTATGACGATGATGA	1
TGATGTTGATGATGATGATGATGTTGATGATGATGATGATGACGATGACGATGATGA	1
TGATGTTGATGATGATGATGATGATGATGATGATGATGATGACGATGACGATGCTGA	1
TGATGTTGATGATGATGATGATGATGATGATGATGATGATGACGAGGACGATGATGA	1
TGATGTTGATGTTGATGATGATGATGATGATGATGATGATGACGATGACGATGATGA	1
TGATGGTGATGATGATGATGATGATGATGATGATGATGATGACGATGACGATGATGA	1
TGATGTTGATGATGATGATGATGATGATGATGATGATGACGACGATGACGATGATGA	1
TGATGTAGTTGATGATGATGCTGCTGATGATGATGATGATGACGATGACGATGATGA	1
TGATGTTGATGATGATGATGATGATGATGATGATGTTGATGACGATGACGATGATGA	1
TGATGTTGATGATGATGATGATGATGATGATGATGATGATGANGATGACGATGATGA	2
TGATGTTGATGATGATGATGATGATGATGATGATGATGATGACGATGACGCTGATGA	1
TGGTGTTGATGATGATGATGATGATGATGATGATGATGATGACGATGACGATGATGA	2
TGATGTTGATGATGATGATGATGATGATGATGATGATGATGACGATGANGATGATGA	1
TGACGTTGATGATGATGATGATGATGATGATGATGATGCTGACGATGACGATGATGA	1
TGACGTTGATGATGATGATGATGATGATGATGATGATGATGACGATGACGATGATGA	1
TGATGTTGATGCTGATGATGATGATGATGATGATGATGATGACGATGACGATGATGA	1
TGATGTTGATGATNATGATGATGATGATGATGATGATGATGACGATGACGATGATGA	1
TGATGTTGATGATGATGATGATGATGCTGATGATGATGATGATGACGATGACGATGATGA	1
TGATGTTGATGATGATGATGATGATGATGATGATGATGATGACGATTACGATGATGA	1
TGATGTTGATGATGATGATGATGATGATGATGANGATGATGACGATGACGATGATGA	1
TGATGTTGATGATTATGATGATGATGATGATGATGATGATGACGATGACGATGATGA	1
TGATGTTGATGATGATGATGATGATGATGATGAGGATGATGACGATGACGATGATGA	1
TGATGTTGATGATGATGATGATGATGATGTTGATGATGATGACGATGACGATGATGA	1
TGATGTTGATGATGATGATGATGATGATGATGATGATGATGATGATGACGATGACGATGATGA	1
TGATGTTGAGGATGATGATGATGATGATGATGATGATGATGACGATGACGATGATGA	1
TCATGTTGATGATGATGATGATGATGATGATGATGATGATGACGATGACGATGATGA	1
TGATGTTGATGATGATGATGATGAAGATGATGATGATGATGACGATGACGATGATGA	1
TGATGTTGATGATGATGATGATGATGATGATGATGATGATGACGNTGACGATGATGA	1
TGATGTNGATGATGATGATGATGATGATGATGATGATGATGACGATGACGATGATGG	1
TGATGTTGATGATGATGAAGATGATGATGATGATGATGATGACGATGACGATGATGA	1
TGCTGTTGATGATGATGATGATGATGATGATGATGATGCTGACGATGACGATGATGA	1
TGATGTTGATGATGAGGATGATGATGATGATGATGATGACGATGACGATGATGA	2
TGATGTTGATGATGATGATGATGAGGATGATGATGATGATGACGATGACGATGATGA	1
TGATGTTGATGACGATGATGATGATGATGATGATGATGATGACGATGACGATGATGA	1
TGATGTTGATGATCATGATGATGATGATGATGATGATGATGACGATGANGATGATGA	1
TGATGTTGATGATGATGATGATGATGATGATGATGATGACGAGGACGATGATGA	1
TGATGTTGATGATGATGATGATGATGATGATGATGATGATGACGATGACGATGTTGA	1
TGATGTTGATGATGATGATGATGATGATGATGATGACGATGACGATGATGA	1
TGATGTTGA	2

Length variants:
57	339
54	24
60	8
48	2
63	1
51	1
9	2

