Subpop report generated 09-07-25 16:08:35

fastq:	/home/amorris/BioInf/BlooMine_WD/BlooMine_paper_reanalysis/gp60_all/SRR26320686_GER30_grouped.CP044417_263000-268000/Cp_gp60_IIa/SRR26320686_GER30_grouped.CP044417_263000-268000.Cp_gp60_IIa_BMfiltered.fq
flanks_fasta flanks:	/home/amorris/BioInf/BlooMine_WD/BlooMine_paper_reanalysis/gp60_all/tmp.Cp_gp60_IIa_flanks.fa


Sequence variants:
TGATGTTGATGATGATGATGATGATGATGATGATGATGATGACGATGACGATGATGA	454
TGATGTTGATGATGATGATGATGATGATGATGATGATGACGATGACGATGATGA	16
TGATGTTGATGATGATGATGCTGATGATGATGATGATGATGACGATGACGATGATGA	2
TGATGTTGATGATGATGATGATGATGATGATGATGATGCTGACGATGACGATGATGA	2
GGATGTTGATGATGATGATGATGATGATGATGATGATGATGACGATGACGATGATGA	2
TGATGTTGATGATGATGATGATGATGATGATGATGATGATGATGATGACGATGATGA	3
TGATGTTGATGATGATGATGATGAGGATGATGAGGATGATGACGATGACGATGATGA	1
TGATGTTGATGATGATGATGATGATGATGATGATGATGAGGACGATGACGATGATGA	1
TGATGTTGATGATGATGATGTTGATGATGATGATGATGATGACGATGACGATGATGA	1
TGATGTTGATGATGATGATGATGATGATGATGAGGATGTTGACGATGACGATGATGA	1
TGATGTTGATGATGATGATGATGATGATGATGATGATGATGACGATGAAGATCAATA	1
TGATGTTGATGATGATGATGATGATGATGATGAGGATGATGACGATGACGATGATGA	3
TGATGTGTATGATGATGATGATGATGATGATGCTGATGATGACGATGACGATGATGA	1
TGATGTTGTTGATGATGATGATGATGATGATGATGATGATGACGATGACGATGATGA	1
TGATGTTGATGATGATGATGATGATGATGATGATGATGCTGATGATGACGATGATGA	1
TGATGTTGATGATGATGATGATGATGATGATGATGATGATGACGAAGACGATGATCA	1
TGATGTTGATGATGATGATGATGATGATGATGATGACGATGACGATGACGATGATGA	1
TGATGTTGATGATGATGATGATGATGATGATGATGATGATGACGATGATGA	1
TGATGTTGATGATGATGATGATGATGATGATGATGACGATGACGATGATGA	1
TGAGGTTGATGATGATGATGATGAGGATGATGATGATGATGACGATGACGATGATGA	1
TGATTTTGATGATGATGATGATGATGATGATGATGATGATGACGATGACGATGATGA	1
TGATGGTGATGATGATGATGATGATGATGATGATGATGATGACGATGACGATGATGA	1
TGGTGTTGATGATGATGAGGATGATGATGATGATGATGATGACGATGACGATGATGA	1
TGATGTTGATGATGATGATGATGATGATGATGATTATGATGACGATGACGATTATCA	1
TGATTTTGATTATGTTGATGTTGATGATGATGATGATGATGACGATGACGTTGATGA	1
TGATGTTGATGATGATGATGATGATGATGATGATGATGATGATGACGATGACGATGATGA	1
TGAGGTTGATGATGATGATGATGATGATGATGATGATGATGACGTTGACGATGATGA	1
TGATGTTGATGATGATGATGATGATGAGGATGATGATGATGACGATGACGATGATGA	1
TGATGTTGATGATGATGATGATGATGATGTTGATGATGATGACGATGACGATGATGA	1
TGATGTTGATGATGATGATGATGATTATGATGATGATGATGACGATGACGATGATGA	1
TGATGTTGATGATGATGATGATGATGATGATGATGATGATGAAGATGACGATGATGA	1
TGATGTTGATGAAGATGATGATGATGATGATGATGAAGATGACGATGACGATGATGA	1
TGATGTTGATGATGATGATTATGATGATGATGATGATGATGACGATGACGATGATGA	1
TGATGTTGATGATGATGTTGATGATGATGATGATGATGATGACGATGACGATGATGA	1
TGATGTTGATGATGATGATGATGATGATGATGATGATGATGACGCTGACGATGATGA	1

Length variants:
57	491
54	16
51	2
60	1

