Subpop report generated 09-07-25 15:04:33

fastq:	/home/amorris/BioInf/BlooMine_WD/BlooMine_paper_reanalysis/gp60_all/SRR26320678_Hun5_grouped.CP044417_263000-268000/Cp_gp60_IIa/SRR26320678_Hun5_grouped.CP044417_263000-268000.Cp_gp60_IIa_BMfiltered.fq
flanks_fasta flanks:	/home/amorris/BioInf/BlooMine_WD/BlooMine_paper_reanalysis/gp60_all/tmp.Cp_gp60_IIa_flanks.fa


Sequence variants:
TGATGTTGATGATGATGATGATGATGATGATGATGATGATGATGACGATGATGATGA	39
TGATGTTGATGATGATGATGATGATGATGATGATGATGACGATGACGATGACGATGATGA	17
TGATGTTGATGATGATGATGATGATGATGGTGATGATGATGACGATGACGATGACGATGATGA	1
TGATGTTGATGATGATGATGATGATGATGATGATGATGATGACGATGACGATGACGATGATGA	206
TGATGTTGATGATGATGATGATGATGATGATGATGATGAGGACGATGACGATGACGATGATGA	2
TGATGTTGATGATGATGATGATGATGATGACGATGATGATGACGATGACGATGACGATGATGA	1
TGAGGTTGATGATGATGATGATGATGATGATGATGATGATGACGATGACGATGACGATGATGA	2
TGATGTTGATGATGATGATGATGATGATGATGATGATGATGATGATGACGATGACGATGATGA	2
TGATGTTGATGATGATGATGATGATGATGATGATGATGATGACGATGATGATGA	7
TGATGTTGATGATGATGATGATGATGATGATGATGATGATGATGACGATGACGATGACGATGATGA	7
TGATGTTGATGATGATGATGATGATGATGATTATGATGATGACGATGACGATGACGATGATGA	1
TGATGTTGATGATGATGATGATGATGATGATGATGATGATGATGATGACGATGACGATGACGATGATGA	1
TGATGTTGATGATGATGATGATGATGATGATGATGATGATGACGATGACGATGACGAAGATGA	1
TGATGTTGATGATGATGATGATGATGATGATGATGATGATGATGATGATGACGATGATGATGA	1
TGATGTTGANGATGATGATGATGATGATGATGATGATGACGACGATGACGATGACGATGATGA	1
TGATGTTGATGATGATGATGATGATGATGATGATGATGATGACGATGACGATGACGATNATGA	1
TGATGTTGACGATGATGATGATGATGATGATGATGATGATGACGATGACGATGACGATGATGA	1
TGATGTTGATGATGATGATGATGATGATGATGAGGATGATGACGATGACGATGACGATGATGA	1
TGATGTTGATGATGATGATGATGATGATGCTGATGATGATGACGATGACGATGACGATGATGA	1
TGATGTTGATGATGATGATGATGATGATGATGATGATGATGATGACGATGACGATCACGATGATGA	1
TGATGTTGATGATGATGATGATGATGATGATGNTGATGATGACGATGACGATGACGATGATGA	2
TCATGTTGATGATGATGATGATGATGATGATGATGATGATGACGATGACGATGACGATGATGA	1
TGATGTTGATGATGATGATGATGATGATGATGATGATGATGATGACGATGACGATGATGA	1
TGATGTTGATGATGATGACGATGATGATGATGATGATGATGATGACGATGATGATGA	1
TGATGATGATGATGATGATGATGATGATGATGATGATGATGACGATGACGATGACGATGATGA	1
TGATGTTGATGATGATGATGATGATGATGATGCTGATGATGACGATGACGATGACGATGATGA	1
TGATGTTGATNATGATGCTGATGATGATGATGATGATGATGACGATGACGATGACGATGATGA	1
TGATGTTGATGATGATGATGATGATGATGATGATGATGATGACGATGCCGATGACGATGATGA	1
TGGTGTTGATGATGATGATGATGATGATGATGATGATGATGACGATGACGATGACGATGATGA	2
TGATGTTGATGATGATGATGATGATGATGATGATGATGATGACGATGACGATGACGANGATGA	1
TGATGTTGATGATGATGATGATGATGATGATGATGATGATGAAGAAGAAGAGGAAGATGATCN	1
TGATGTTGATGATGATGATGATGATGATGATGATGATGATGACGATGACGATGACGATGATGN	1
TGATGTTGATGATGATNATGATTATGATGATGATGATGATGACGATGACGATGACGATGATGA	1
TGATGTTGATGATGATGATGATGATGATGATGACGATGACGATGATGA	1
TGATGTTGATGATGATGATGATGATGATGATGATGATGATGATGACGATGANGATGA	1
TGATGTTGATGATGATGATGATGATGATGATGATGACGATGACGATGACGATGATGA	1
TGATGTTGATGATGATGATGATGATGATGAGGATGATGACGATGACGATGACGATGATGA	1
TGANGTTGATGATGATGATGATGATGATGATGATGATGCTGACGATGACGATGACCATGATGA	1
TGATGTTGATGATGATGATGATNATGATGATGATNATGACGATGACGATGACGATGATGA	1
TGATGTTGATGATGATGATGATGATGATGAGGATGATGATGATGACGATGATGATGA	1
TGATGTTGATGATGATGNTGATGATGATGATGATGATGATGACGATGACGATGACGATGATGA	1
TGATGTTGATTAAGATGATGAGTATGATGATGATGATGATGACGATGACGATGACGATGATGA	1
TGATGGTGATGATGATGATGAGGATGAAGATGATGATGATGACGATGACGAGGACGATGATGA	1
TGATGTTGATGATGATGATGATGATGATGATGATGATGCCGATGACGATGACGATGATGA	1
TGATGTTGATGATGATGATGATGACGATGATGATGATGATGACGATGACGATGACGATGATGA	1
TGATGTTGATGATGATGATGATGATGATGATGATGATGTTGACGATGACGATGACGATGATGA	1
TGATGTTGATGATGATGGTGATGATGATGATGATGATGATGATGACGATGATGATGA	1
TGATGTTGATGATGATGATGATGATGCTGATGATGATGATGACGATGACGATGACGATGATGA	1
TGATGTTGATGATGATGATGATGATGACGATGATGATGATGACGATGACGATGACGATGATGA	1
TGATGTTGATGATGATGATGATGATGATGATGATGATGATGACGATGACGATGACGATGNTGA	1
TGATGTTGATGATGATGATGATGAAGATGATGATGATGATGACGATGACGATGACGATGATGA	1
TGATGTTGATGATGATGATGATGATGATGATGATNACGATGACGATGACGATGATGA	1
TGATGTTGTTGATGATGATGATGATGATGATGATGATGAGGACGATGACGATGACGATGATGA	1
TGATGTTGATGATCATGATGATGATGATGATGATGATGATGACGATGACGATGACGATGATGA	1
TGATGTTGATGATGATGATGATGATGATGATGATGATGATGATGATGACGATGAAGAAGA	1

Length variants:
57	45
60	22
63	247
54	7
66	8
69	1
48	1

