Subpop report generated 09-07-25 12:42:13

fastq:	/home/amorris/BioInf/BlooMine_WD/BlooMine_paper_reanalysis/gp60_all/SRR26320702_GER13_grouped.CP044417_263000-268000/Cp_gp60_IIa/SRR26320702_GER13_grouped.CP044417_263000-268000.Cp_gp60_IIa_BMfiltered.fq
flanks_fasta flanks:	/home/amorris/BioInf/BlooMine_WD/BlooMine_paper_reanalysis/gp60_all/tmp.Cp_gp60_IIa_flanks.fa


Sequence variants:
TGATGTTGATGATGATGATGATGATGATGATGATGATGATGACGATGACGATGATGA	235
TGATGATGATGATGATGATGATGATGATGATGATGATGATGATGACGATGATGA	1
TGATGTTGATGATGATGATGATGATGATGATGATGATGACGATGACGATGATGA	19
TGATGTTGATGATGATGATGATGATGATGATGATGATGATGACGATGACGAGGATGA	1
TGATGTTGATGATGATGATGCTGATGATGATGATGATGATGACGATGACGATGATGA	1
TGATGTTGATGATGATGTTGATGATGATGATGATGATGATGACGATGACGATGATGA	1
TGATGTTGATGATGATGATGATGCTGATGATGATGATGATGACGATGACGATGATGA	1
TGATGTTGATGATGATGATGATGATGATGATGATGACGATGACGATGATGA	1
GGATGTTGATGATGATGATGATGATGATGATGATGATGATGACGATGACGATGATGA	1
TGATGTTGATGATGATGATGATGATGATGATGATGATGATGATGACGATGACGATGATGA	4
TGATGTTGATGATGATGATGATGATGATGATGATGATGATGAAGATGACGATGATGA	1
TGAGGTTGATGATGATGTTGATGATGATGATGATGATGATGACGATGACGATGATGA	1
TGATGTTGATGATGATGATGATGATGATGATGACGATGACGATGATGA	1
TGATGTTGATGATGATGATGATGATGATGATGATGATGATGATGACGATGATGA	2
TGATGTTGATGATGATGATGATGATGATGATGATGATGAGGACGATGACGATGATGA	1
TGATGTTGATGATGATGATGATGATGATGATGATGATGATGACGATGATGA	1
TGTTGTTGATGATGATGATGATGATGATGATGATGATGATGACGATGACGATGATGA	3
TGATGGTGATGATGATGATGATGATGATGATGATGATGATGACGATGACGATGATGA	1
TGATGTTGATGATGATGATGATGATGATGATGATGAAGATGACGATGACGATGATGA	1
TGATGTTGATGATGATGATGTTGATGATGATGTTGACGATGAAGATGACGATTATGA	1
TGATGTTGATGATGATGATGATGATGCTGATGATGATGATGACGATGACGATGATGA	1
TGATGTTGATGATGATGATGCTGATGATGCTGCTGATGATGACGATGACGATGATGA	1
TGATGTTGATGAGGATGATGATGATGATGATGATGATGATGCCGAGGACGATGATGA	1
TGATGTTGATGATGATGATGATGATGATGAGGATGATGACGATGACGATGATGA	1
TGATGTTGATGATGATGATGATGATGATGATGATGATGATGAAGAAGACGATGATGA	1
TGATGTTGATGATGATGATGATGATGATGATGATGAGGACGATGACGATGATGA	1
TGATGTTGATGATGATGATGATGAGGATGATGATGATGATGACGATGACGATGATGA	1
TGATGTTGATGATGCTGATGATGATGATGATGATGCTGATGTCGATGACGATGATGA	1
TGATGATGATGATGATGATGATGATGATGATGATGATGATGACGATGACGATGATGA	1
TGATGTTGATGATGATGATGAAGATGATGATGATGATGATGCCGATGACGATGATGA	1
TGATGTTGATGATGTTGATGATGATGATGATGATGATGATGACGATGACGATGATGA	3
TGATGTTGCTGATGATGATGATGATGATGATGTTGATGATGACGATGACGATGATGA	1
TGATGTTGATGAGGATGATGATGATGATGAAGATGATGAGGACGCTGACGATGATGA	1
GGCTGTTGCTGAGGATGATGAGGATGATGATGCTGATGATGACGATGACGATGATGA	1
TGATGTTGATGATGATGATGATGATGATGATGAGGATGATGACGATGACGATGAGGA	1
TGAGGTTGATGATGATGATGATGATGATGATGATGATGATGACGATGACGATGATGA	1
TGATGTTGATGATGATGATGATGATGATGATGATGATGATGACGAGTACGATTATGA	1
TGATGTTGATGATGATGATGATGATGATGATGATGCTGAGGACGATGACGATGATGA	1
GGATGTTGTGGATGTTGATGATGATGATGATGATGATGATGACGATGACGATGATGA	1
TGATGTTGATGATGATGATGAAGATGATGATGATGATGACGATGACGATGATGA	1
TGATGTTGATGATGATGATGATGAAGATGAAGATGATGACGATGACGATGATGA	1
TGATGTTGATGATGATGATGATGATGATGATGATGATGATGATGACGATGTCGATGATGA	1
TGATGATGATGATGATGATGATGATGATGATGATGATGACGATGACGATGATGA	1
TGATGTTGTTGATGCTGATGATGATGATGATGATGATGACGATGACGATGATGA	1

Length variants:
57	268
54	28
51	2
60	5
48	1

