Subpop report generated 09-07-25 13:00:54

fastq:	/home/amorris/BioInf/BlooMine_WD/BlooMine_paper_reanalysis/gp60_all/SRR26320670_Nor3_grouped.CP044417_263000-268000/Cp_gp60_IIa/SRR26320670_Nor3_grouped.CP044417_263000-268000.Cp_gp60_IIa_BMfiltered.fq
flanks_fasta flanks:	/home/amorris/BioInf/BlooMine_WD/BlooMine_paper_reanalysis/gp60_all/tmp.Cp_gp60_IIa_flanks.fa


Sequence variants:
TGATGTTGATGATGATGATGTTGATGATGATGATGATGATGATGACGATGATGA	352
TGATGTTGATGATGATGATGTTGATGATGATGATGATGATGAGGACGATGATGA	4
TGATGTTGATGATGATGATGTTGATGATGATGATGATGATGATGACGAGGATGA	1
TGANGTTGATGATGATGATGTTTATGATGATGATGATGATGATGACGATGATGA	1
TGATGTTGATGATGATGATGTTCATGATGATGATGATGATGATGACGATGATGA	1
TGATGTTGATGATGATGATGTTGATGATGATGATGATGATGACGATGATGA	10
TGATGTTGATGATGATGATGTTGATGATGATGATGATGATGATGCCGATGATGA	3
TGATGTNGATGATGATGATGTTGATGATGATGATGATGATGATGACGATGATGA	1
TGATGTTGATGATGATGATCTTGATGATGATGATGATGATGACGATGATGA	1
TGATGTTGATGATGATGATGTTGATCATGATGATGATGATGATGACGATGATGA	1
TGATGTTGATGATGATGATGTTGATGATGATGATGATGATGATCACGATGATGA	1
TGATGTTGATGATGATGATGTTGATGATGATGATGATGAGGATGACGATGATGA	1
TGATGTTGATGATGATGATGTTGATGATGATGCTGATGATGATGACGATGATGA	2
TGATGTTGATGATGATGATGTTGATGATGATGATGATGCTGATGACGATGATGA	1
TGATGTTGAAGATGATGATGTTGATGATGATGATGATGATGATGACGATGATGA	1
TGATGTTGATGATGATGATGTTGATGCTGATGATGATGATGATGACGATGATGA	1
TGATGTTGATGATGATGATGGTGATGATGATGATGATGATGATGACGATGATGA	1
TGATGTTGATGATGATGATGTTGATGATGNTGATGATGATGATGACGATGATGA	2
TGATGTTGATGATGATGATGTTGATGATGATGATGATGATGATGACGATGAAGA	1
TGATGTTGAGGATGATGATGTTGATGATGATGATGATGATGATGACGATGATGA	1
TGATGTTGATGATGATGATGTTGATGATGATGATGATGATGANGACGATGATGA	1
TGATGTTGATGATGATGATGTTGATGATGATGATGATGATGATGNCGATGATGA	1
TGATGTTGATGATGATGANGTTGATGATGATGATGATGATGATGACGATGATGA	3
TGATGTTGATGATGATGATNTTGATGATGATGATGCTGATGATGACCATGATGA	1
TGATGTTGATGATGATGATGTTGATGATGATGATGATGATCATGACGATGATGA	1
TGATGTTGATGATGATGATGTTGATGATGACGATGATGATGATGACGATGATGA	1
TGATGTTGATGATGATGATGTTGATGATGGTGATGATGATGATGACGATGATGA	1
TGATGTGGATGATGATGATGTTGATGATGATGATGATGATGATGACGATGATGA	1
TGGTGTTGATGATGATGATGTTGATGATGATGATGATGATGATGACGATGATGA	1
TGATGTTGATGAGGATGATGTTGATGATGATGATGATGATGATGACGATGATGA	1
TGATGTTGATGATCATGATGTTGATGATGATGATGATGATGATGACGATGANGA	1
TGATGTTGATGATGATGATGTTGATGATGATGATGATGATGATGACGGTGATGA	1
TGATGTTGATGATGATGATGTTGATGATGATGATGATGATGATGACGAAGATGA	1
TGATGTTGATGATGATGATGTTGATGATGATGATGATGGTGATGACGATGATGA	1
TGATGTTGCTGATGATGATGTTGATGATGATGATGAAGATGATGACGATGATGA	1
TGATGTTGATGATGATGATGTTGATGATGATGAAGATGATGATGCCGATGATGA	1
TGATGTTGATGATGATGATGTTNATGATGATGATGATGATGATGACGATGATGA	1
TGATGTTGATGATGATGATGTTGATGATGATGATGATGATGATGGCGATGATGA	1
TGATGTTGATGATGATGATGTTGATGATGATGATGATGATGATGACGATNATGA	1
TGATGTTGATGATGATGATGTTGANGATGATGATGATGATGATGACGATGATGA	1
TGATGTTGATGATGATGATGTTGATGATGATGATGATGATCATCACGATGATGA	1
TGATGTTGATGATGATGATGTTGATGATGATGATGATGACGATGATGA	1
TGATGTTGATGATGATGATGTTGATGATGATGANGATGATGATGACGATGATGA	1
TGATGTTGATGATGATGATGTTGATGATGATGATGATGATGCTGACGATGATGA	1
TGATGTTGATGATGATGATGTTGATGATGATGATGATGATGATGATGACGATGATGA	1
TGATGTTGATGATGANGATGTTGATGANGATGATGATGATGATGACGATGATGA	1
TGATGTTGATGATGATGATGTTGATGATGATGACGATGATGATGACGATGATGA	1
TGATGTTGATGATGATGATGTTGATGANGATTATGATGATGATGACGATGATGA	1
TGATGTTGATGATGATGATGTTGATGATGATGATGATGATGATGACGCTGATGA	1
TGATGTTGATGATGATGATGTTGATGNTGATGATGATGATGATGACGATGATGA	1
TGATGTTGATGATGATGNTGTTGATGATGATGATGATGATGATGACGATGATGA	1
TGATGTTGATGATGATGATGTTGATGATGATGAAGATGATGATGACGATGATGA	1
TGATGTTGATGATGATGATGTCGATGCTGATGATGATGATGATGACGATGATGA	1
TGATNTTGATGATGATGATGTTGATGATGATGATGATGATGATGACGATGATGA	1
TGATGTTGATGATGATGATGAGGATGACGATGATGA	1

Length variants:
54	410
51	11
48	1
57	1
36	1

