Subpop report generated 09-07-25 13:21:05

fastq:	/home/amorris/BioInf/BlooMine_WD/BlooMine_paper_reanalysis/gp60_all/SRR26320652_UKP107_grouped.CP044417_263000-268000/Cp_gp60_IIa/SRR26320652_UKP107_grouped.CP044417_263000-268000.Cp_gp60_IIa_BMfiltered.fq
flanks_fasta flanks:	/home/amorris/BioInf/BlooMine_WD/BlooMine_paper_reanalysis/gp60_all/tmp.Cp_gp60_IIa_flanks.fa


Sequence variants:
TGATGTTGATGATGATGATGATGATGATGATGATGATGATGATGATGACGATGATGA	11
TGATGTTGATGATGATGATGATGATGATGATGATGATGATGATGATGATGACGATGATGA	362
TGATGTTGATGATGATGATGATGCTGATGATGATGATGATGATGATGATGACGATGATGA	1
TGATGTTGATGATGATGATGATGATGATGATGATGATGACGATGATGATGACGATGATGA	1
TGATGTTGATGATGATGATGACGATGATGATGATGATGATGATGATGATGACGATGATGA	7
TGATGTTGATGATGATGATGAAGATGATGATGATGATGATGATGATGATGACGATGATGA	1
TGATGTTGATGATGATGATGATGATGATGATGATGATGATGTTGATGATGACGATGATGA	1
TGATGTTGTTGATGATGATGATGATGATGATGATGATGATGATGATGATGACGATGATGA	1
TGATGTTGATGATGATGATGATGATGATGATGATGATGATGATGATGATGACGCTGATGA	1
TGATGTTGATGATGATGATGATGATGATGATGATGATTATGATGATGATGACGATGATGA	1
TGATGTTGATGATGGTGATCATGATGATGATGATGATGATGATGATGATGACAATGATGA	1
TGTTGTTGATGATGATGATGATGATGATGATGATGATGATGATGATGATGACGATGATGA	3
TGATGTTGATGATGATGATGATGATGATGATGATGATGAGGATGATGATGACGATGATGA	1
TGATGTTGATGATGATGATGATGGTGATGATGATGATGATGATGATGATGACGATCATGA	1
TGATGTTGATGATGATGATGATGATGATGATGATGATGATGATGATGATGACGATGATTA	1
TGATGTTGATGATGATGATGATGAAGATGATGATGATGATGATGATGATGACGATGATGA	1
TGATGTTGATGATGATGATGATGATGATGATGATGATGATGACGATGATGACGATGATGA	1
TGATGTTGATGATGATGATGATGATGATGTTGATGATGATGATGATGATGACGATGTTGA	1
TGATGTTGATGATGATGATGATGATGATGATGATGATGATGATGATGATGGCGATGATGA	2
TGATGTTGATGATGATGATGATGATGAGGATGATGATGATGATGATGATGACGATGATGA	2
TTATGTTGATGAAGATGATGATGATGATGATGATGATGATGATGATGATGACGATGATGA	1
TGATGTTGATGATGATGATGATGATGATGATGTTGATGATGATGATGATGACGATGATGA	1
TGATGTTGATGATGATGATGATGATGCTGATGATGATGATGATGATGATGACGATGATGA	1
TGATGTTGATGATGATGATGATGATGATGATGATGATGATGATGATGATGACGATGGTGA	2
TGATGTTGATGATGATGATGATGATGATGATGATGATGATGGTGATGATGACGGTGATGA	1
TGATGTTGATGATGATGATGATGATGATGATGATGATGATGATGACGATGATGA	1
TGATGTTGATGATGATGATGATGATGATGATGATGATGATGATGATGATGCCGATGATGA	1
TGATGTTGATGATGATGATGATGTTGATGATGATGATGATGAGGATGGTGACGATGATGA	1
TGATGTTGATGATGATGATGAGGATGATGATGGTGCTGATGATGATGATGACGATGATGA	1
TGATGTTGATGATGATGATGATGATGATGTTGAGGATGATGATGATGAAGACGATGATGA	1
TGATGTTGATGATGATGATGATGATTATGATGATGATGATGATGATGATGACGATGATGA	1
TGATGTTGATGATGATGATGATGATGTTGTTGATGATGATGATGATGATGACGATGATGA	1
TGATGTCGATGATGATGATGATGATGATGATGATGATGATGATGATGATGACGATGATGA	1
TGATGTTGATGATGATGATGATGATGATGATGATGATGATGATGATGATGTCGATGATGA	2
GGATGTTGATGATGATGATGATGATGATGATGATGATGATGATGATGATGACGATGATGA	1
TGATGTTGATGATGTTGATGATGATGATGATGATGATGATGATGATGATGACGATGATGA	1
TGATGTTGATGATGATGATGATGATGATGATGATGTTGATGATGATGATGACGATGATGA	1
TGATGTTGATGTTGATGCTGACGATGATGCTGATGATGGTGATTATTATGGCGATGATGA	1
TGATGTTGATGATGATGATGATGATGATGATGATGATGATGATGATGCTGACGATGATGA	1
TGATGTTGATGATGATGATGATGATGTTGATGATGATGATGATGATGATGACGATGATGA	1
TGATGTTGATGATGAAGATGATGAAGAAGATGATGATGATGATGATGATGACGATGATGA	1
TGATGGTGATGATGATGATGATGATGATGCTGAGGATGATGATGATGATGACGATGATGA	1
TGATGTTGATGATGATGATGATGATGATGATGATTATGATGATGATGATGACGATGATGA	1
TGATGTTGATGATGATGATGATGATGATGATGATGATGATGATCATGATGACGATGATGA	1
TGATGTTGATGATGATGAGGATGATGATGATGATGAGGATGATGATGATGACGATGATGA	1
TGATGGTGATGATGATGATGATGATGATGATTATGATGATGATGCTGATGACGATGATGA	1
TGATGTTGATAATGATGATGATGATGATGAAGATGAGTGTGCTGAAGATGACGACGTTGA	1
TGATGTTGATGATGATGATGATGATGATGATGATGATGATGATGATGCTGACTATGATGA	1
TGATGTTGATGATGATGATGATGATGATGATGATGATGATGACGATGATGA	1
TGATGTTGATGATGATGATGATGATTATGATGATTATTATGATGATGATGACTATGATGA	1
TGATGTTGATGATGATGATGATGATGATGATGATGAGGATGATGATGATGACGATGATGA	1
TGATGTTGATGATGATGATGATGATGATGAGGATGATGATGATGATGATGACGATGATGA	1
TGATGTTGATGATGTGGATGATGATGATGATGATGATGATGATGATGCTGACGATGATGA	1
CGATGTTGATGATGATGATGATGATGATGATGATGATGATGATGATGATGACGATGATGA	1
GGCTGTTGATGATGATGATGGTGCTGATGATGATGATGATGATGATGATGACGATGATGA	1
TGATGTTGATGATGATGAGGATGATGATGATGCTGATGATGCTGATGATGACGATGATGA	1
TGATGTTGATGATGATGATGATGATGAGGATGATGATGATGATGATGATGACGATGATGC	1
TGATGGTGATCATGATGATGATGATGATGAGGATGAGGATGATGATGACGATGATGA	1
TGATGTTGATGATGATGATGATGATGGTGATGAAGATGATGACGATTATGACGATGATGA	1
TGATGTTGATTATGATGATGATGATGATGATGATGATGATGATGATGATGACGATGATGA	1
TGATGGTGATGATGATGATGATGATGATGATGATGATGATGATGATGATGACGATGATGA	1
TGATGTTGATGATGTTTACTATGATGATGCTGATGATGATGATGATGATGACGATGATGA	1

Length variants:
57	12
60	431
54	1
51	1

