Subpop report generated 09-07-25 12:26:41

fastq:	/home/amorris/BioInf/BlooMine_WD/BlooMine_paper_reanalysis/gp60_all/SRR26320653_UKP106_grouped.CP044417_263000-268000/Cp_gp60_IIa/SRR26320653_UKP106_grouped.CP044417_263000-268000.Cp_gp60_IIa_BMfiltered.fq
flanks_fasta flanks:	/home/amorris/BioInf/BlooMine_WD/BlooMine_paper_reanalysis/gp60_all/tmp.Cp_gp60_IIa_flanks.fa


Sequence variants:
TGATGTTGATGTTGATGATGATGATGATGATGATGATGATGATGATGATGACGATGATGA	109
TGATGTTGATGTTGATGATGATGATGATGATGGTGATGATGATGATGATGACGATGATGA	1
TGATGTTGATGTTGATGATGAGGATGATGATTATGATGATGATGATGATGACGATGATGA	1
TGATGTTGATGTTGATGATGATGATGATGATGATGATGTTGATGATGATGACGATGATGA	1
TGATGTTGATGTTGATGATGATGATGATGATGTTCATGATGATGATGATAACGATGATGA	1
TGATGTTGATGTTGATGTTGATGATGATGATGATGATGATGATGATGATGATGATGACGATGATGA	1
TGATGTTGATGTTGATGATGATGATGCTGAGGATGCTGACGAGGTTGATGACTATGATCC	1
TGATGTTGATGTTGATGATGATGATGATGGTGATGATGACGCTGATGAAGACTATGATGA	1
TGATGTTGATGTTGATGATGATGATGATGATGATGATGATGATGATGATGACGACGATGA	1
TGATGTTGATGTTGATGATGATGATGATGATGATGATGATGGTGATGATGGCGATGATGA	1
TGATGTTGTTGTTGATGATGATGATGATGATGATGATGATGATGATGATGACGATGATGA	2
TGATGTTGATGTTGAGGATGATGATGATGATGATGATGATGATGATGATGACGATGATGA	1
TGAGGTTGATGTTGATGATGATGATGATGATGATGATGATGATGATCATGACGATGATGA	1
TGATGTTGATGTTGATGATGATGATGATGCTGATGATGATGATGATGATGACGAGGATGA	1
TGATGTTGATGTTGATGATGATGATGATGATGATGATGATGATGATGAAGACGATGATGA	1
TGATGTTGATGTTGATGTTGATGATGATGATGATGATGATGATGATGATGACGATGATGA	1
TGATGTTGATGTTGATGATGATGATGATGAAGATGAGGATGATGATGATGACGATGATGA	1
TGATGTTGATGTTGATGATGATGATGATGATGATGATGATTATGATGATGACGATGATGA	1
TGCTGTTGATGTTGATGATGATGATGATGATGATGATGATGATGATGATGACGATGATGA	1
TGATGTTGATGTTGATGATGATGATGATGATGATGATGATGATGATGACGATGATGA	1
TGATGTTGATGTTGATGATGATGATGATGATGATGATGATGATGATGATGTCGATGATGA	1
TGATGTTGATGTTGATGATGATGCTGATGATGATGATGATGATGATGATGACGATGATGA	1
TGATGTTGATGTTGATGATGATGATGATGATGATGATGATGATGATGATGCCGATGATGA	1
TGATGATGATGTTGATGATGATGCTGATGATGATGATGATGATGATGCCGATGATGA	1
TGATGTTGATGTTGATGATGATGATGGTGATGATGATGATGATGATGATGACGATGATGA	1
TGATGTTGATGTTGCTGATGATGATGATGATGATGATGATGATGATGATGACGATGATGA	1
TGATGTTGATGTTGATCATGATGATGACGATGATGATGATGATGATGATGACCATGATGA	1

Length variants:
60	133
66	1
57	2

