Subpop report generated 01-08-25 02:55:49

fastq:	/home/arthur/BioInf/Crypto_work/fastq/BM_paper_missing/BlooMine_RUNDIR/SRR3091754_CP0035D9/Cp_gp60_IIa/SRR3091754_CP0035D9.Cp_gp60_IIa_BMfiltered.fq
flanks_fasta flanks:	/home/arthur/BioInf/Crypto_work/fastq/BM_paper_missing/BlooMine_RUNDIR/tmp.Cp_gp60_IIa_flanks.fa


Sequence variants:
TGATGTTGATGATGATGATGATGATGATGATGATGATGATGATGATGACGACGATGATGA	2
TGATGTTGATGATGATGATGATGATGATGATGATGATGATGATGATGATGACGATGATGA	42
TGATGTTGATGATGATGATGATGATGATGATGATGCTGATGATGATGATGACGATGATGA	1
TGATGTTGATGATGATGATGATGATGATGATGATGATGATGATGATGTTGACGATGATGA	1
TGATGTTGATGATGATGATGATGATGATGATGATGATGATGATGATGATGATGACGATGATGA	1
TGATGTTGATGATGATGATGATGATGATGATGAGGATGATGATGATGATGACGATGATGA	1
TGAGGTTGATGATGATGATGATGATGATGATGATGATGATGATGATGATGACGAGGATGA	1
TGATGTTGATGATGATGAAGATGATGATGATGATGATGATGATGATGATGATGACGATGATGA	1
TGATGTTGATGATGATGATGATGATGATGATGATGATGATGAGGATGACGATGATGA	1
TGATGTTGATGATGATGATGATGATGATGATGATGATTATGATGATGATGACGATTATTA	1
TGATGTTGATGATGATGATGATGATGATGATGATGCTGATACTGATGATGACGATGATGA	1
TGATGTTGATGATGATGATGATGATGATGATGATGATGATGATGATGATGATGA	1
TTATGTTGATAAGGGTGATGATGATCATGAGATTGATGATAATGATAATGACAATGATGG	1
TGATGTTGATGATGATGATGTTGATGATGATGATGATGATGATGATGATGACGATGATGG	1
TGATGGTGATGATGATGATGATGATGATGATGATGATGATGATGATGATGACGATGATGA	1
TGATGTTGATGATGATGATGATGATGAGGATGATGATGATGATGATGATGACGATGATGA	1
TGATGTTGATGATGATGATGATGATGATGATGATGATGATGTTGATGATGACGGTGATGA	1
TGATGTTGATGATGATGATGATGATGATGATGAAGATGATGATGATGATGACGATGATGA	1

Length variants:
60	56
63	2
57	1
54	1

