Subpop report generated 01-08-25 06:38:02

fastq:	/home/arthur/BioInf/Crypto_work/fastq/BM_paper_missing/BlooMine_RUNDIR/SRR3091752_CP0035C8/Cp_gp60_IIa/SRR3091752_CP0035C8.Cp_gp60_IIa_BMfiltered.fq
flanks_fasta flanks:	/home/arthur/BioInf/Crypto_work/fastq/BM_paper_missing/BlooMine_RUNDIR/tmp.Cp_gp60_IIa_flanks.fa


Sequence variants:
TGATGTTGATGATGATGATGATGATGATGATGATGATGATGATGATGATGACGATGATGA	123
TGATGTTGATGATGATGATGATGATGATGATGATGATGATGATGATGACGATGATGA	22
TGATGATGATGATGATGATGATGATGATGATGATGATGATGATGATGACGATGATGA	1
TGATGTTGATAATGATGATGATGATGATGATGATGATGATGATGATGAGGTCGATGATGA	1
TGCTGTTGATGATGATGATGATGATGATGATGATGATGATGATGATGATGATGACGATGATGA	1
TGATGTTGATGATGATGATGATGATGATGATGATGATGATGATGACGATGATGA	6
GGATGTTGATGATGATGATGATGATGATGATGATGATGATGATGATGATGACGATGATGA	2
TGATGGTGATGATGATGATGATGATGATGATGATGATGATGATGATGATGACGATGATGA	2
TGATGTTGATGATGATGATGATGATGATGATGCTGATGATGATGATGATGACGATGATGA	2
TGATGTTGATGATGATTATGATGATGATGATGATGATGATGATGATTATGACGATGATGA	1
TGATGTGGATGATGATGATGATGATGATGATGATGATGATGATGATGATGACGATGATGA	1
TGATGTTGATGATGATGATGATGATGATGATGATGATGATGAAGATGACGATGATGA	1
TGATGTTGATGATGATGATGATGATGATGATGATGATGATGATGATGATGATGACGATTATGT	1
TGATGCTGATGATGATGATGATGATGATGATGATGATGATGATGATGATGACGATGAAGA	1
TGATGTTGATGATGATGATGATGATGATGATGATTATGATGATGATGATGACGATGATGA	1
GGATGTTGATGATGATGATGATGATGATGATGATGATGATGATGATGACGATGATGA	1
TGATGTTGATGATGATGATGATGATGATGATGATGATGATGATGATGAGGACGATGATGA	1
TGATGTTGTTGATGATGATGATGATGATGCTGATGATGATGATGATGATGACGATGATGA	1
TGATGTTGATGATGATGATGATGATGATGATGATGATGATGATGATAACGATGCTGA	1
TGATGTTGATGATGATGATGATGATGATGATGATGATGATGATGATGATGACGATTATGA	1
TGATGTTGATGATGATGATGATGATGATGATGATGATGAGGATGATGATGACGATGATGA	1
TGATGTTGATGATGATGATGATGATGATGATGATGACGATGATGA	1
TGATGTTGATGATGATGATGATGATGATGATGATGATGATGAGGATGATGACGATGATGA	1
TGATGTTGATGATGATGATGATGATGATGATGATGATGATGATGATGATGACGAGGATGA	1
TGATGTTGATGATGATGATGAGGATGATGATGATGATGATTATGATGATGACGATGATGA	1
TGATGTTGCTGATGATGATGATGATGATGATGATGATGATGCTGATGATGACGATGATGA	1
TGATGTTGATGATGATGATGATGATGAGGATGATGATGATGATGATGATGACGATGATGA	1
TGATGTTGATGATGATGATGATGATGATGATGATGATGGTGATGATGATGACGATGATGA	1
TGATGTTGATGATGATGATGATGATGATGATGATGATGATGATGATGATGATGACGATGATGA	3
TGATGTTGATGATGATGATGATGATGATGATTATGATGATGATGATGATGATGACGATGATGA	1
TGAGGTTGATGATGATGATGATGATGATGATGATGATGATGATGATGATGACGATGATGA	1
TGATGTNNNNNNNGATGATGATGATGATGATGATGATGATGANGATGATGACGANNATGA	1
TGATGTTGATGCTGATGATGATGATGATGATGATGATGATGATGATGATGACGATGATGA	1
TGATGTTGATGATGATGATGATGATGATGATGATGATGATGATGATGATGATGATGATGACGATGATGA	1
TGATGTTGATGATGATTCTGATGATGATGATGTTGATGATGATGATGATGACGATGATGA	1
TGATGTTGATGATGAGGATGATGATGATGATGATGATGATGATGATGATGACGATGATGA	1
TGATGTTGATGATGATGATGATGATGATGATGATGATGATGATGATGATGACGATGATGG	1
TGCTGTTGAAGAAGATGCTGATGATGATGATGATGATGATGATGATGATGACGATGATGA	1
TGATGTTGATGATGATGATGATTATGATGATGATGATTATGATGATGATGACGATGATGA	1
TGATGTTGACGATGATGATGATGATGATGATGATGATGATGATGATGATGACGATGATGA	1
TGCTGTTGATAATGATGATGATGATGAAGATGATGATGATGATGATGATGACGATGATTA	1
TGATGATGATGATGATGATGATGCTGATGATGATGATGATGATGACGATGATGA	1
TGATGTTGATGATGATGATGATGATGATGCTGATGATGATGATGATGATGACGATGCTGA	1
TGATGTTGATGATGCTGATGATCATGATGATGATGATGATGATGATGATGACGATGATGA	1
TGATGTTGATGATGATGATGATGATGAGGATGATGATGATGATGATGATGACGATGAGGA	1
TGATGTTGATGATGATGATGATGATGATGATGATGATGATGATGATGATGACGATGAGGA	1

Length variants:
60	158
57	26
63	6
54	7
45	1
69	1

