Subpop report generated 01-08-25 01:53:36

fastq:	/home/arthur/BioInf/Crypto_work/fastq/BM_paper_missing/BlooMine_RUNDIR/SRR3091759_CP0036C6/Cp_gp60_IIa/SRR3091759_CP0036C6.Cp_gp60_IIa_BMfiltered.fq
flanks_fasta flanks:	/home/arthur/BioInf/Crypto_work/fastq/BM_paper_missing/BlooMine_RUNDIR/tmp.Cp_gp60_IIa_flanks.fa


Sequence variants:
TGATGTTGATGATGATGATGATGATGATGATGATGATGATGATGATGATGACGATGATGA	18
TGATGTTGATGATGATGATGATGATGATGAGGATGATGATGATGATGATGACGATGATGA	1
TGATGTTGATGATGATGATGATGATGATGATGATGGTGATGATGATGATGACGATGATGA	1
NNNNNTTGATGATGATGATGATGATGATGATGATNATGATGATGATNNTGACGATGATGA	1
TGATGTTGATGATGATGATGATGATGATGATGATGATGATGATGATGATGATGATGATGA	1
TGATGTTGATGATGATGATGATGATGATGATGATGATGATGATGATGACGATGATGA	2
TGATGTTGATGATGATGATGATGATGAGGATGATGATGATGATGATGATGACGATGATGA	1
TGATGTTGATGATGATGATGATGATGATGATGATGATGATGATGACGATGATGA	2
TGATGTTGATGATGATGATGATGATGATGATGATGATGATGATGACGATGACGATGATGA	1
TGATGTTGATGATGATGATGATGATGATGATGATGATGATGATGGTGATGACGATGATGA	1
TGAGGTTGATGATGATGATGATGATGAGGATGATGATGATGATGATGATGACGAGGATGA	1
TGATGTTGATGATGATCATGATGATGATGATGAATATGATGAGGATGATGACGGTGATGG	1
TGATGTTGATGATGATGATGATGATGAAGCTGATGATGATGATGATGATGACGATGTTGA	1
TGATGTTGATGATGATGATGATGATGATGATGATGATGATGATGTTGAGGACTATGATGA	1
TGAGGATGATGAGGAAGATGATGAGGAGGAGGGTGGGTGGGAAAATGATGACAAAGAAGA	1
TGATGTTGATGATGATGATGATGATGAGGAGTATGATGATGATGATGATGACGATGATGA	1
TGGTGTCGATGACGATGATGATGGTGATGTCGATGATGTTGATGAGGATGCCGATGATGA	1

Length variants:
60	32
57	2
54	2

