Subpop report generated 01-08-25 12:58:28

fastq:	/home/arthur/BioInf/Crypto_work/fastq/BM_paper_missing/BlooMine_RUNDIR/SRR3091755_CP0035F4/Cp_gp60_IIa/SRR3091755_CP0035F4.Cp_gp60_IIa_BMfiltered.fq
flanks_fasta flanks:	/home/arthur/BioInf/Crypto_work/fastq/BM_paper_missing/BlooMine_RUNDIR/tmp.Cp_gp60_IIa_flanks.fa


Sequence variants:
TGATGTTGATGATGATGATGATGATGATGATGATGATGATGATGATGATGACGATGATGA	142
TGATGTTGATGATGATGATGATGATGATGATGATGATGATGATGATGATGACGATGAAGA	1
TGATGTTGATGATGATGATGATGATGATGATGATGATGATGATGATGACGATGATGA	15
TGATGTTGATGATGATGATGATGATGANNNNNNNGATGATGATGATGATGACGATGATGA	1
TGANNTTGATGATGATGATGATGATGATGATGATGATGATGATGATGATGACGATGATGA	1
TGATGTTGATGATGATGATGATGATGATGAGGATGATGATGATGATGATGACGATGATGA	1
TGATGATGATGATGATGATGATGATGATGATGATGATGATGATGATGATGATGATGATGACGATGATGA	1
TGATGTTGATGATTATGATGATGATGATGATGATGATGATGATGATGATGACGATGATGA	1
TGATGTTGATGATGATTATGATGATGATGATGATGATGATGATGATGATTACGATGATGA	1
TGATGTTGAGGATGATGATGATGAGGATGATGATGATGATGATGATGAGGACGACGATGA	1
TGATGTTGATGATGATGATGATGATGATGATGATGATGATGAGATGATGACGATGATGA	1
TGATGTTGATTATGATGATGATGATGATGATGATGATGATGATGATGATGACGATGATGA	1
TGATGTTGATGATGATGATGATGATGATGATGATGATTATGATGATGATGACGATGATGA	1
TGATGTTGATGATGATGATGATGATGATGATGATTATGATGATGTTGATGACGATGATGA	1
TGATGTTGATGAGGATGATGATGATGATGATGATGATGATGATGTTGAGGAAGATGATGA	1
TGATGTTGATGATGATGATGATTATGATGATGATGATGATGATGATGATGACGATGATGA	1
TGATGTTGATGATGATGATGATGATGATGATGATGATGATGATGATAATGACGATGATGA	1
TGATGTTGATGATGATGATGATGATGATGATGATGATGATGATGATGCCGATGAGGA	1
TGATGTTGATGATGATGATGATGATGATGATGATGATGATGATGACGATGACGATGATGA	1
TGATGTTGATGATGATGAGGATGATGATGATGATGATAATGATGATGATGACGATGATGA	1
TGATGTTGATGACGATACTGATGATGATGATGATGATGATGATGATGATGACGATGATGA	1
TGATGTTGATGATGATGATGATGATGATGATGATGATGATGATGATGATGATGATGATGA	2
GGATGTTGATGATGATGATGATGATGATGATGATGATGATGATGATGATGACGATGATGA	1
TGATGTTGATGATGATGATGATGATGATGATGATGATGATGATGACGATGATGA	3
TGATGTTGATGATGATGATGATGATGATGATGATGATGATGATGATGATGATGACGATGATGA	2
TGATGTTGCTGATGATGATGATGATGATGATGATGATGATGATGATGATGACGATGATGA	1
TGCTGTTGATGATGATGATGATGATGATGATGATGATGATGATGATGATGAAGATGATGA	1
TGATGTTGATGATGATGATGATGATGATGATGATGATGATGATGATGACGAAGAAGA	1
TGATGTTGATGATGATGATGATGATGATGATGATGAGGATGATGATGATGACGATGATGA	2
TGCTGTTGATGATGATGATGATGATGATGATGATGATGATGACGATGATGA	1
TGATGTTGATGATGATGATGATGATGATGATGATGATGATGACGATGATGA	1
TGATGTTGATGATGATGATGATGATGATGATGATGATGCTGATGATGATGACGATGATGA	1
TGATGTTGATGATTATGATGATGATGATGATGATGATGATTATGATGATGACGATGATGA	1
TGATGTTGATGATGATGATGATGATGCTGATGATGATGAGGATGAGGATGACGATGATGA	1
TGATGTGGATGATGATGATGATGATGATGATGATGATGATGATGATGATGACGATGATGA	1
TGATGTTGATGATGATGATGATGATGAGGATGATGATGATGATGATGATGACGATGATGA	1
TTATGTTGATGATGATGATGATGATGATGAGGATGATGATGATGATGCTGACGATGATGA	1
TGATGTTGATGATGATGATGATGATGATGATGAAGATGATGATGATGATGACGATGATGA	1
TGATGTTGATGATGATGATGCTGATGATGATGATGATGATGATGATGATGACGATGATGA	1
TGATGTTGATGATGATGATGATGATGATGATGATGCTGATGATGATGATGACGATGATGA	1
TGATGTTGATGATGAGGATGATGATGATGATGATGATGATGATGATGATGACTATGATGA	1
TGATGTTGATGATGATTATGATGATGATGATGATGATGATGATTATGATGACGATGATGA	1
TGATGTTGATGATGATGATTATGATGATGATGATGATGATGATTAGGATGACGATGATGA	1
TGATGTTGATGATGAGGATGATGATGATGATGATGATGATGATGATGATGACGATGATGA	1
TGATGTTGATGATGATGATGATGATGATGATGATGATGATGATGCTGATGACTATGATGA	1
GGATGTTGATGATGATGATGATGATGATGATGATGATTATGAGGCTGATGGCGATGATGT	1
TGATGTTGATGATGATGATGATGATGATGATGATGATGATGAGGATGATGACGATGATGA	1
TGATGTTGCTGATGATGATGATGATGATGATGATGATGATGATGATGATGACGATGCTGA	1
TGATGTTGATGATGATGATGATGATGATGATGATGATGATGATGTTGATGACGCTGCTGA	1
TGATGTTGATGATGCTGATGATGATGATGATGATGATGATGATGATGATGACGATGATGA	1
TGATGTGGATGATGATGATGATGATGATGATGATGATGATGATGATGACGATGATGA	1
TGATGTTGTTGATGATGATGATGATGATGATGATGATGATGATGATGATGACGATGATGA	1
TGATGTTGCTGATGATGAGGATGATGATGATGATGATGATGATGATGATGACGATGATGA	1
TGATGTTGATGATGATGATGATGATGATGAAGATGATGATGAGGATGATGACGATAATGA	1
GGATGTTGATGATAATGATGATGGTGAAGATGATGATGATGATGATGGTGACGATGATGA	1
TGATGTTGATGATGATGATGATGATGATGATGATGATGATGATGATGATGACGATTATGA	1
TGGTGTTGATGATGATGATGATGATGATGATGAAGATCATGATGATGATGACGAAGATGA	1
TGATGTTGATGATGATGATGACGATGATGATGATGATGATGATGATGATGACGATGAGGA	1

Length variants:
60	191
57	18
69	1
59	1
54	3
63	2
51	2

