Subpop report generated 09-07-25 12:37:29

fastq:	/home/amorris/BioInf/BlooMine_WD/BlooMine_paper_reanalysis/gp60_all/SRR6871415_UKP1_grouped.CP044417_263000-268000/Cp_gp60_IIa/SRR6871415_UKP1_grouped.CP044417_263000-268000.Cp_gp60_IIa_BMfiltered.fq
flanks_fasta flanks:	/home/amorris/BioInf/BlooMine_WD/BlooMine_paper_reanalysis/gp60_all/tmp.Cp_gp60_IIa_flanks.fa


Sequence variants:
TGATGTTGATGATGATGATGATGATGATGATGATGATGATGATGATGACGATGATGA	21
TGATGTTGATGATGATGATGATGATGATGATGATGATGATGATGATGATGACGATGATGA	501
TGATGTTGATGATGATGATGATGATTATGATGATGATGATGATGATGATGACGATGATGA	1
TGATGTTGATGATGATGATGATGATGATGATGATGATGATGATGATGATTACGATGATGA	1
TGATGTGGATGATGATGATGATGATGATGATGATGATGATGATGATGATGACGATGATGA	1
TGATGTTGATGATGATGATGATGATGATGATGATGATGATGATGATGATGGCGATGATGA	1
TTGATGTTGATGATGATGATGATGATGATGATGATGATGATGATGATGATGACGATGATGA	1
TGATGTTGATGATGGTGATGATGATGATGATGATGATGATGATGATGATGACGATGATGA	1
TGATGTTGATGATGATGAGGATGATGATGATGATGATGATGATGATGACGATGATGA	1
TGATGTTGATGATGATGATGATTATGATGATGATGATGATGATGATGATGACGATGATGA	1
TGATGTTGATGATGATGATGATGATGATGATGATGATGATGCTGATGATGACGATGATGA	1
TGATGTTGATGATGACGATGATGATGATGATGATGATGATGATGATGATGACGATGATGA	1
TGATGTTGATGATGATGATGATGATGATGAGGATGATGATGATGATGATGACGATGATGA	2
TGATGTTGATGATGATGATGATGATGATGATGATGAAGATGATGATGATGACGATGATGA	1
TGATGTTGATGATGATGATGATGATGATGATGATGATGATGATTATGATGACGATGATGA	1
TGATGTTGATGATGATGATGATGATGATGATGATGATGAGGATGATGATGACGATGATGA	1
TGATGTTGATGATGATGATGATGATGATGATGATGATGATGATGATGATGACGAGGATGA	2
TGATGTTGATGACGATGATGATGATGATGATGATGATGATGATGATGATGACGATGATGA	1
TGATGTTGATGATGATGATGATGATGATGATGATGATGATGATGATGATGATGACGATGATGA	3
TGATGTTGATGATGATGATGATGATGATGTTGATGCTGATGATGATGATGACGATGATGA	1
TGATGTAGATGATGATGATGATGATGATGATGATGATGATGATGATGATGACGATGATGA	1
TGATGTTGATGATGATGATGATGATGATGATGATGATTATGCTGATGATGACGATGATGA	1
TGATGTTGATGATGATGATGATGATGATGATCATGATGATGATGATGATGACGATGATGA	1
TGATGTTGATGATGATGATGATGATGATGATGATGATGATGATGATGATGACAATGATGA	1
TGCTGTTGATGATGATGATGATGATGATGATGATGATGATGATGATGATGACGATGATGA	1
TGATGTTGATGATGATGATGATGATGATGATGATGATGATGATGAGGATGACGATGATGA	1
TGATGGTGATGATGATGATGATGATGATGATGATGATGATGATGATGATGACGATGATGA	1
TGATATTGATGATGATGATGATGATGATGATGATGATGATGATGATGATGACGATGATGA	1
TGATGTTGATGATGATGATGATGATGATGATGATGATGATGACGATGATGACGATGATGA	1

Length variants:
57	22
60	527
61	1
63	3

