Subpop report generated 09-07-25 14:59:47

fastq:	/home/amorris/BioInf/BlooMine_WD/BlooMine_paper_reanalysis/gp60_all/UKP223.CP044417_250000-300000/Cp_gp60_IIa/UKP223.CP044417_250000-300000.Cp_gp60_IIa_BMfiltered.fq
flanks_fasta flanks:	/home/amorris/BioInf/BlooMine_WD/BlooMine_paper_reanalysis/gp60_all/tmp.Cp_gp60_IIa_flanks.fa


Sequence variants:
TGATGTTGATGATGATGATGATGAGGATGATGATGATGATGACGATGACGATGATGA	2
TGATGTTGATGATGATGATGATGATGATGATGATGATGATGACGATGACGATGATGA	166
TGATGTTGATGATGATGATGAGGATGATGATGATGATGATGACGATGACGATGATGA	1
TGATGTTGAGGATGATGATGATGATGATGATGATGATGATGACGATGACGATGATGA	1
TGATGTTGATGATGATGATGAAGCTGCAGCCCATGATGATGACGATGACGATGATCA	1
TGATGTTGATGATGATGATGATGATTATGATGATGATGATGAAGATGACGATGATGA	1
TGATGTTGATGATGATGATGATGATGATGATGAAGATGATGACGATGAAGATTATGA	1
TGATGTTGATGATGATGATGATGATGATGATGATGATGATGACGATGACGATGATGN	1
TGATGTTGATGATGATGATGATGATGATGATGATGATGATGAAGATGACGATGATGA	2
TGATGTTGATGATGATGATGATGATGATGATGATGATGCTGACGATGACGATGATGA	1
TGATGTTGATGATGATGCTGATGATGATGATGATGATGATGACGATGACGATGATGA	2
TGATGTTGATGATGATGATGATGCTGATGATGATGATGATGACGATGACGATGATGA	1
TGATGTTGATGATGATGATGATGATGATGATGATGANGATGACGATGACGATGATGA	1
TGATGTTGATGATGATGAGGATGATGATGATGATGATGATGACGATGACGATGATGA	1
TGATGTTGATGATGATGATGATGATGATGATGATGATGACGATGACGATGATGA	1
TGAGGTTGATGATGATGAGGATGATGATGATGATGATGATGACGATGACGATGATGA	1
GGATGTTGATGAGGATGATGATGATGATGATGATGATGATGACGATGACGATGATGA	1
TGATGTTGATGATGATGATGATGATGATGATGATGATGATGACGATGACGATGATGC	1
TGAGGTGGATGATGATGATGATGATGATTTTGATGATGATGACGATGACGATGATGA	1
TGATGTTGATGATGATGATGATGATGCTGATGATGATGATGACGATGACGATGATGA	1

Length variants:
57	187
54	1

